80 80
################################################################################
#    #     #        #                               #                   #      #
#    #     #        #                               #                   #      #
#    #              #                               #                   #      #
#    #              #                                                   #      #
#    #              #                                         #         #      #
#    ##########    ##                                         #         #      #
#    #                   ###########################     #### #         #      #
#    #                                              #         #         #   ####
#    #                                              #         #         #      #
#    #                                              #         #         #      #
#             #     #                          #    #         #         #      #
#             #     #                          #    #         #         #      #
#             #                                     #         #####            #
#     ######    ################################### #         #                #
#    #               #                              #         #                #
#    #               #                              #         #                #
#    #               #                              #         #         #      #
#    #         #     #                              #                   #      #
#    ####      ###   #                              #####    ########## #      #
#    #         #     #                              #                   #      #
#    #         #      ######    ################### #                   #      #
#    #         #              #                     #                   #      #
#    #         #              #                     #                          #
#    #         #              #                     ####    ####################
#    #######    #### #                              #             #            #
#    #               #                              #                          #
#    #               #                              #                          #
#    #               #                              #                          #
#    #               #        #                     #                          #
#    #               #        #                     #      *                   #
#    #                                                                         #
#    ######################################################    #################
#    #                                 #    #    #                 #           #
#    #                                 #    #    #                 #           #
#    #                                 #    #    #                 #           #
#    #                                 #    #    #                 #           #
#    #                                 #    #    #                             #
#    ###########    ################## #    #    #                             #
#    #     #                   #       #    #    #                             #
#    #     #                   #       #    #    ############    ###############
#    #     #                   #       #    #    #      #        #         #   #
#    #     #                   #       #    #    #      #        #         #   #
#    #     ##############      #       #    #    #      #        #         #   #
#    #     #     #      #      #       #         #               #         #   #
#    #     #     #      #      #       #         #               #         #   #
#    #     #     #      #      #       #         #               #         #   #
#    #     #     #             #       #         #            ## #   ##### #   #
#    #     #     #             #       #   ##### #      #        #         #   #
#    #     #     #             #       #    #    #      #                  #   #
#    #     #     ##########    #       #    #    #      #                  #   #
#    #     ##    #     #       #       #    #    #      #                  #   #
#    #     #     #     #       #       #    #    #      ######    ######## #   #
#    #     #     #     #               #    #    #      #    #             #   #
#    #     #     #     #                    #    #      #    #             #   #
#    #                 #             ##     #    #      #    #             #   #
#    #                 #####                #    #      #                      #
#    #                         #            #    #      #                      #
#    #                         #       #         #      #                      #
#    #     #     #             #       #         #      #                      #
#    #     #     #             #       #         #      ##########    ##########
#    #     #                           #         ###    #      #           #   #
#    #     #########################   #    #    #      #      #           #   #
#    ###   #    #    #          #      #    #    #      #      #               #
#    #     #    #    #          #      #    #    #      #                      #
#    #     #         #                 #    #    #      #                      #
#    #     #                           #    #           #           ############
#    #     #                           #    #           ####           #       #
#    #     ######     ##########    ## #    #           #      #               #
#    #     #    #          #           #    #           #      #               #
#    #     #    #    #     #           #    #           #      #               #
#    #     #         #     #           #                #                      #
#    #     #         #     #      #    ###############    ######################
#    #     #         #     #      #    #                                       #
#    #     #         #     ####    ### #                                       #
#    #     #    #    ###   #           #                                       #
#    #     #    #    #                 #        #                              #
#    #     #    #    #                 #        #                              #
#    #     #    #    #                 #        #                              #
################################################################################
