80 80
################################################################################
#       #        #                    #      #     #                       #   #
#       #        #                           #     #                           #
#       #        #                           #     #                           #
#  #### #        #                           ##    ###############    #####    #
#       #        #                           #     #                           #
#       #        #####    ###################      #                       #   #
#       #        #                                 #                       #   #
#       #        #                                 #                       #   #
#       #        #                                 #             #         #   #
#       #        #                           #     #             #         #   #
#       #        #############################     #             #             #
#       #        #        #      #    #       #    ###########    ##############
#       #        #        #      #    #       #    #    #       #     #    #   #
#       #        #                    #       #    #    #       #     #    #   #
#       #        #                    #       #    #    #       #     #    #   #
#       #        #             ##     #       #    #    #       #     #    #   #
#       #        #                    #       #    #    #       #     #    #   #
#       #        ######   #      #    #       #    #    #       #     #    #   #
#        ##      #        #      #    #       #    #    #       #     #        #
#                #        #      #    #####   #    #    #       #     #        #
#                #        #      #    #            #    #   ####      #        #
#                #        #######     #            #    #             #        #
#       #        #        #           #            #    #        ##   #    #   #
#       #        #        #           #            #    #             #    #   #
#       #        #        #           #       #    #    #       #     #    #   #
#       #        #        #     #     #       #    #    #       #     #    #   #
#       #        #        #     #     #       #    #    #       #     #    #   #
#       #        #                    #       #    #    #       #     #        #
#       #        ##########    ###### #            #    #       #     #    #####
#       #        #        #            ##    ##### #    #       #     #    #   #
#       #        #        #                #       #    #       #     #        #
#       #        #        #                #       #    #       #     #        #
#       #                 #                #       #    #       #              #
#       #                 #           #    #            #       #              #
#       #                 #########   #    #    ###     #       #          #   #
#                         #      #    #                 #       #          #   #
##############   #        #      #    #                 #       #     #    #   #
#   #      #     #        #      #    #            #    #       #     #    #   #
#   #      #     #        #      #    #            #    #       #     #    #   #
#   #      #     #        #      #    #    #       #    #       #     #    #   #
#   #      #     #               #    #    #       #    #       #     #    #   #
#   #            #               #    #    #       #    #       #     #    #   #
#   #            #                    #    #       #    #       #     #    #   #
#   #            #                    #    #       #    #       #     #    #   #
#   #            #        #           #    #       #    #       #     #    #   #
#   #      #     #        #           #    #       #    #       #     #    #   #
#   #      #     #        #      #    #    #       #    #       #     #    #   #
#   #      #     #        #      #    #    #       #            #     #    #   #
#          #     #        #      #    #    #       #            #     #    #   #
#          #     #        #*     #    #    #       #            #     #    #   #
#          #     ###      #      #    #    #       #            #     #    #   #
#    ###    #### #        #      #    #    #       #    #       #     #    #   #
#   #            #        #      #    #    #       #    #       #     #    #   #
#   #            #        #      #    #    #       #    #       #     #    #   #
#   #            #        #      #    #    #       #    #       #     #    #   #
#                #                                 #    #       #     #    #   #
#################    ############################# #    #       #     #    #   #
#                       #       #             #    #    #       #     #    #   #
#                       #       #             #    #    #       #     #    #   #
#                       #       #                  #    #       #     #    #   #
#      #     #          #       #                  #    #       #              #
#      #     #    #     #           ##########     #    #       #############  #
#      #     ######     #                          #    #       #          #   #
#######      #          #                     #    #    #       #          #   #
#            #          #                     #    #    #       #              #
#            #          #    ## #             #    #    #       #              #
#            #          #       #                  #    #                      #
#                       #       ################   #    #    ###################
###############    #### #       #             #    #    #             #        #
#     #                 #       #                  #    #             #        #
#                               #                  #    #             #        #
#                               #                  #    #                      #
#                                                  #    #     #                #
#                        #########    ############ #    ##    #                #
#     #   ############# #                #         #    #     ###    ###########
#     #                 #                          #    #     #                #
#     #                 #                          #    #     #                #
#     #                 #                          #    #     #                #
################################################################################
