80 80
################################################################################
#                                                                  #           #
#                                                                  #           #
#       #       #                                           #      #           #
#       ####    #                                           #      #     #     #
#       #       #                                           #      #     #     #
#       #       #                                                  #           #
#       #       ####################    ########################## #   #########
#       #       #                                 #          #     #       #   #
###     #       #                                 #          #     #       #   #
#       #       #                                            #     #       #   #
#       #       #                                            #     #       #   #
#       #       ##############################     ####      #     ####    #   #
#       #       #                                            #             #   #
#               #                                 #                        #   #
#############   #                                 #                        #   #
#    #     #    #                                             ##           #   #
#    #     #    ##############    ###########################      #           #
#    #     #    #                                            #     #           #
#    #     #    #                                            #     #           #
#    #     #    #                                            #     #           #
#    #          #                                       #    #     #       #   #
#    #          #                                       #    #     #       #   #
#    #          #                                       #    #     #       #   #
#    #          #                                                              #
#    ##    #    #################    ###########################################
#    #     #    #       #    #    #    #                                       #
#    #     #    #       #    #    #    #                                       #
#    #     #    #       #         #    #                                       #
#    #     #    #       #         #    #                     #                 #
#    #     #    #       #         #                          ############    ###
#    #     #    #       #         #                          #    #       #    #
#    #     #    #       #    #    #                          #    #       #    #
#    #     #    #       #    #    #                          #    #            #
#    #     #    #             #### #######################   #    #            #
#    #     #    #            #                               #    #            #
#    #     #    #            #                               #    ###########  #
#    #     #    #            #                               #    #            #
#    #     #    #       #    #    #                          #                 #
#    #     #    #       #    #    #                          #                 #
#    #     #    #       #    #    #                          #                 #
#    #     #    #       #    #    ###########################    ###############
#    #     #    #       #    #    #          #                                 #
#    #          #       #         #                                            #
#    #   ###### #       #         #                                            #
#    #     #    #       #         #                                            #
#    #     #    #       #                                                      #
#          #    #####   #############    #######################################
#          #    #       #     #                    #       #    #        #     #
#          #    #       #     #                    #       #    #        #     #
#          #    #       #     #                    #            #        #     #
#    #     #    #       #     #                    #            #              #
#    #     #    #       #     #                    #            #              #
#    #     #    #       #     #         #          #            #              #
#    #     #    #       ##    #         #          #       #    #######    #####
#    #     #    #       #      ######    ######### #       #    #        #     #
#    #     #    #       #                          #       #    #        #     #
#    #     #    #       #                                  #    #        #     #
#    #     #    #       #                                  #    #        #     #
#    #     #    #       #                                  #    #        #     #
#    #          #       ###########    ############        #             #     #
#    #          #       #     #    #       #       #       #     ###          ##
#    #          #       #          #       #       #       #                   #
#    #          #       #          #       #       #       #                   #
#    #     #    #       #          #       #       #       #                   #
#    #     #    #       #          #       ###     #       #                   #
#    #     #    #       #          #       #       #       #   #################
#    #     #    #       ######     ###    ##       #       #         #         #
#    #     #    #       #     #    #            *  #       #         #         #
#    #     #    #       #     #    #               #       #         #         #
#    #     #    #       #     #                    ##      #         #         #
#    #     #    #       #     #                    #       #         #         #
#    #     #    #       #    ##                    #       #                   #
#    #     #    #       #                          #       #                   #
#    #     #    #       #          #########    ## #       #                   #
#    #     #    #       #          #               ######    ###################
#    #     #    #       #          #               #                           #
#    #     #    #       #     #    #               #                           #
#    #     #    #       #     #    #               #                           #
################################################################################
