80 80
################################################################################
#                                                   #             #      #     #
#                                                   #                    #     #
#                                                   #                    #     #
##########    ##################################### ##########        ## #     #
#   #     #                     #                                        #     #
#         #                     #                                 #      #     #
#                               #                                 #      #     #
#                               #                                        #     #
#              ########    #### #################   #######    ######### #     #
#              #                #             #     #     #     #        #     #
#         #    #                #             #     #     #     #        #     #
#####     #    #                #             #     #                    #     #
#   #     #    #                #             #     #                    #     #
#         ##    ################    ######### #     #            ##      #     #
#         #                                   #     #                    #     #
#         #                                   #     #           #        #     #
#         #                                   #     #           #        #     #
#                               #             ###   ##    ##### #        #     #
#    ########################## ##    ##      #     #    #      #        #     #
#                               #      #   ## #     #    #      #        #     #
#                               #      #      #     #    #      #        #     #
#                               #      #            #    #      #        #     #
#                               #      #            #           #        #     #
#               #               #      #            #           #        #     #
#               #                                                        #     #
################    #################################################### #     #
#        #    #    #                #                            #       #     #
#        #    #    #                                                     #     #
#        #    #    #                                                     #     #
#        #         #                                                     #     #
#   #    #         #                                                     #     #
#   #### #         #########################    ################ ####    #     #
#        #         #                                             #       #     #
#        #    #    #                                             #       #     #
#        #    #    #                                             #       #     #
#             #    #                                                     #     #
#   #         #    ###########################    ###################### #     #
#   #         #    #            #                      #                 #     #
#   #         #    #                                   #                 #     #
#             #    #                                   #                 #     #
#  ########## #    #                                   #           #     #     #
#       #     #    #                                   #           #     #     #
#       #     #    ###############    ################ #                 #     #
#       #     #    #        #                                ########### #     #
#       #     #    #        #                                    #       #     #
#             #    #        #                                    #       #     #
#             #    #        #                                    #       #     #
#             #                                        #                 #     #
#             #                                        #                 #     #
#       #     #                                        #                 #     #
#       #     #                                                          #     #
#       #     #############    ######################################### #     #
##      #     #        #        #                                   #    #     #
#       #     #        #        #                                   #    #     #
#       #     #        #        #                                        #     #
#       #     #        #        #                                        #     #
#       #     #        #        #                                        ##    #
#       #     #        #        #################################    ### #     #
#       #     #        #####    #                    #                   #     #
#       #     #        #        #                    #                   #     #
#       #     #        #        #                    #                   #     #
#       #     #        #                                                       #
#       #     #        #                                                       #
#       #     #        #                                                       #
#       #     #        ##################################    ############    * #
#       ###   #                                          #     #    #    #     #
#       #     #                                          #     #         #     #
#       #     #                                          #     #         #     #
#       #     #                                                #         #     #
#       #     #        #                                       #         #     #
#       #     #        #                                       #####     #     #
#       #     ######   #                                       #         #     #
#       #     #        #                                                 #     #
#       #     #        #                                                 #     #
#       #     #        #######    #############################          #     #
#       #     #        #                                                 #     #
#       #     #        #                                       #    #    #     #
#       #     #        #                                       #    #    #     #
################################################################################
