80 80
################################################################################
#       #            #                  #                            #    #    #
#       #            #                  #                            #    #    #
#       #            #                  #                            #    #    #
#       #                               #                            #    #    #
#       #                               ######################    ## #    #    #
#       #                               #       #      #     #       #    #    #
#       #                               #       #      #     #       #    #    #
#       ######################    ##### #       #      #     #       #    #    #
#       #    #    #    #          #     #       #      #     #       #    #    #
#       #    #    #    #          #     #       #      #    #####    #    #    #
#       #         #    #          #     #       #      #             #    #    #
#       #         #    #     #    #     #       #      #             #    #    #
#       #         #    #     #    #             #      #             #    #    #
#       #####     #          #    #             #      #             #    #    #
#       #         #          #    #             #      #     #       #    #    #
#       #               #####     #                    #     #       #    #    #
#       #                   #     #     #              #     #       #    #    #
#       #              #    #     #     #              #             #         #
#       #######    ### #    #     #     #              ##    ####### #         #
#       #              #          #     #       #      #      #      #         #
#       #              #          #     #       #      #      #      #         #
#       #              #          #     #       #      #      #      #    #    #
#       #                         #     ####    #      #      #      #    #    #
#       #######################   #     #       ###    #      #      #    #    #
#       #      #      #      #    #     #       #      #      ##     #    #    #
#       #      #      #      #    #     #       #      #      #      #    #    #
#       #      #      #      #    #     #       #      #             #    #    #
#       #      #      #      #    #     #       #      #             #    #    #
#       #      #   ## ###    #    #     #       #      #             #    #    #
#       #      #      #      #    #     ########    ## #             #    #    #
#       #      #      #      #    #     #    #    #    ##    ##      #    #    #
#       #      #      #      #    #     #         #    #      #      #    #    #
#       ####   #      #           ##    #                     #      #    #    #
#       #             #           #     #                     #      #    #    #
#       #             #           #     #                     #      #####    ##
#       #             #           #     #    #####            #           #    #
#       #             #      #    #     #    #         #      #           #    #
#       #             #      #    #     #    #         #      #                #
#       #             #      #    #     #    #         #      #                #
#       #########     #      #    #     #                     #                #
#       #     #       #      #    #    *#####################    ###############
#       #     #       #      #    #     #      #                          #    #
#       #     #       #      #    #     #      #                               #
#       #     #       #      #    #     #      #                               #
#       #   ##        #      #    #     #      #                               #
#       #             #      #          #      #                               #
#       #             #      #          #      #                               #
#       #             #      #          #      #                               #
#       #     #       #      #          #      ######################    #######
#       #     #       #      #    #     #      #          #                    #
#       #     #       #           #     #      #                               #
#       #     #       ########    #     #      #                               #
#       #     #       #           #     #      #                               #
#       #     #####               #     #      #                               #
#       #     #                   #     #      ########   ##############    ####
#       #     #              #    #     #                 #                    #
#       #     #              #    #     #                 #                    #
#       #     #              #    #     #                 #                    #
#       #                                                                      #
#       ##################################################################    ##
#       #                                                     #                #
#       #                                                     #                #
#       #                                                     #                #
#       #                                                     #                #
#                                                             #                #
#        ########    ######################################## #                #
#                         #       #                            #####    ########
#                         #       #                                #    #      #
#       #                         #                                #    #      #
#       #                         #                                     #      #
#       #                         ###################    #### #                #
#       ##############    ####### #                 #         #                #
#       #          #              #                           #   ######       #
#       #          #                                          #    #     ##    #
###     #                                                     #         #      #
#       #                                                     #         #      #
#       #                                           #         #         #      #
#       #                         #                 #         #         #      #
################################################################################
