80 80
################################################################################
#         #                #                        #    #         #       #   #
#         #                #                        #    #         #       #   #
#   #     #                #                        #    #         #       #   #
#   #     ########    #### #   #################### #    #    #####        #   #
#   #     #     #          #        #               #    #    #            #   #
#         #     #          #        #               #    #    #            #   #
#######   #     #          #        #               #    #    #            #   #
#    #    #     #                   #               #    #    #    #           #
#    #    #     #####    ## ##      ##########      #    #    #    #           #
#    #    #     #                                   #    #         #           #
#    #    #     #                                   #    #         #           #
#    #    #                #                        #    #         #       #   #
#    #    #                #                        #              #       #   #
#    #    #                                         #         #    #       #   #
#         #####################    ################ #         #    #           #
#         #                               #         #              ####    #####
#  ##     #                               #         #    ######### #       #   #
#         #                               #         #        #     #       #   #
#    #                                    #         #        #     #       #   #
#    #     #############    ############# ####      #        #     #       #   #
#    #                                              #        #     #       #   #
#    #                                              #        #     #       #   #
#    #                                              #        #     #       #   #
#                                                   #        #     #       #   #
#################################################   #        #     #       #   #
#                                              #    #        #     #       #   #
#                                              #    #####    #     #       #   #
#                                              #    #        #     #       #   #
#                                              #    #        #     #       #   #
##########################################     #    #        #     #       #   #
#     #                                        #    #        #     #       #   #
#     #                                             #        #     #       #   #
#     #                                                      #     #       #   #
#     #                                                      #     #       #   #
#      ###################    #################              #     #       #   #
#                                   #          #                   #       #   #
#                                   #          #    #              #       #   #
#                                              #    #              #       #   #
#                                              #    #              #       #   #
#                                              #                   #       #   #
#############################################    ################# #       #   #
#                #      #                                    #     #       #   #
#                #      #                                    #     #       #   #
#                #      #                                    #     #       #   #
#                #      #                        #           #     #       #   #
#####    ####### #      #########    ########### #   ####### #     #       #   #
#           #    #      #     #      #      #    #           #     #       #   #
#           #    #      #     #      #      #    #                 #       #   #
#           #    #      #     #      #      #    #                 #       #   #
#           #           #            #      #    #                 #       #   #
#  ######## #           #                  ##    #    ############ #       #   #
#    #      #           #                        #          #      #       #   #
#    #      #           ##    #######            #          #      #       #   #
#    #           #      #     #                  #                 #       #   #
#                #      #            #           #                 #       #   #
#                #                   #   ####### ####    ### ##    #       #   #
#                #                   #           #                 #       #   #
#                                    #           #          #      #       #   #
##    ##################      #      #           #          #      #       #   #
#       #     #    #    #     #                 *                  #####   #   #
#       #     #    #    ####    ################################## #       #   #
#       #     #         #      #                  #       #        #       #   #
#       #     #         #      #                  #       #        #       #   #
#####   #     #         #                         #       #        #       #   #
#             #         #                         #       #        #       #   #
#             #    #    #                         #                #       #   #
#             #    #    #                         #                #       #   #
#             #    #    #                         #                #       #   #
#             #    #    #                         #                #       #   #
#             #         ###################    ###    ############ #       #   #
##    ####### #    #### #                #              #          #       #   #
#             #    #    #                #                         #       #   #
#             #         #                #                         #       #   #
#                       #                #        #                #           #
#   #                   ####    ######## ######   ##     ###    ## #           #
#   #                   #                         #     #          #           #
#   #              #    #                         #     #          #           #
#   #         #    #    #                         #     #          #       #   #
################################################################################
