80 80
################################################################################
#   #    #        #                   #                          #       #     #
#   #    #        #                   #                          #       #     #
#   #    #        #        #          #                          #       #     #
#                 #   #### ######              #                 #       #     #
#                 #        #                   #            #    #       #     #
#                 #        #                   #########    #### #       #     #
#                 #        #                ## #                 ##      #     #
#   #    ###      #                   #        #                 #       #     #
#   #    #        ##############      #        #                 #       #     #
#   #    #        #    #              #        #                 #       ##    #
#   #    #        #    #              #        #                 #       #     #
#   #    #        #    #              #        #                 #       #     #
#   #    #        #    #              #                          #       #     #
#   #    #        #    ###   #        ###    ################### #       #     #
#   #    #        #    #     #        #                          #       #     #
#   #    #        #    #     #        #                                  #     #
#   #    #        #          #        #                                  #     #
#   #    #        #          #        #                                  #     #
#   #    #        #          #        ######    ######################## #     #
#   #    #        #          #        #                    #    #        #     #
#   #    #        #    #     #        #                    #    #        #     #
#   #    #        #    #     #    ### #                    #    #        #     #
#   #    #        #          #        #     #              #    #        #     #
#   #    #            ###### #        #     #              #    #        #     #
#   #    #                   #        #     #              #    #        #     #
#   #    #                   #        #                    #    #        #     #
#   #    #                   #        ###########    ##### #    #        #     #
#   #    #        #    #     #        #    #    #    #     #    #        #     #
#   #    #        #    #     #        #         #    #     #    #        #     #
#   #    #        #    #     #        #         #    #     # *  #        #     #
#   #    #                   #        #         #    #     #    #        #     #
#   #    ####################    #### #              #     #    #        #     #
#   #    #         #          #       #    #         #     #    #        #     #
#   #    #         #          #       #    #####     #     #    #        #     #
#   #    #         #          #       #    #         #     #    #        #     #
#   #    #         #          #       #    #    #    #     #    #        #     #
#   #    #         #######            #    #    #    #     #    #        #     #
#   #    #         #                  #    #    #    #     #    #        #     #
#   #    #         #                  #         #          #    #        #     #
#   #    #                            #         #          #    #        #     #
#   #    #                            #         #          #    #        #     #
#   #    #          ####    ######### #         #   ###### #    #        #     #
#   #    #                  #    #    #    #    #               #        #     #
#   #    #         #        #    #    #    #    #               #        #     #
#        #         #        #    #    #    #    #               #        #     #
#   #### #         #             #    #    #    #               #        #     #
#   #    #         #             #    #    #    #    ##    #    #        #     #
#   #    #         #             #    #    #    #     #    #    #        #     #
#   #    #         #             #    #    #    #     #    #    #        #     #
#   #    #         #    ### #    #    #    #    #     #    #    #        #     #
#   #    #         #        #    #    #    #    #     #    #    #        #     #
#   #    #         #        #    #    #                    #    #        #     #
#   #    #         #        #    #    ###################    ## #        #     #
#   #    #         #        #    #    #     #      #    #       ######   #     #
#   #    #         #             #    #     #      #    #       #        #     #
#   #    #         ###    ###### #    #            #    #       #        #     #
#   #    #         #             #    #            #    #       #        #     #
#   #    ####      #             #    #            #    #       #        #     #
#   #    #         #             #    #            #    #       #        #     #
#   #    #         #       #     #    #                 #       #        #     #
#   #    #         #       #     #    #                 #       #        #     #
#        #         #       #          ##########        #       #        #     #
#        #         #       #          #       #                 #        #     #
#                  #                  #       #    #            #        #     #
################    ################# #       #    #     ###    #        #     #
#     #                      #        #       #    #            #        #     #
#     #                      #        #       #    #    #       #        #     #
#     #                      #        #       #    #    #       #        #     #
#                            #        #   ### #    #                     #     #
#              ###########   #   #### #       #    ########              #     #
#              #                      #            #                     #     #
#########      #                      #            #                           #
#   #          #                      #            #                           #
#              #                      #                                        #
#              ########    ########## ###############    #######################
#              #                      #                                        #
#              #                      #                                        #
#   #          #                      #                                        #
################################################################################
