80 80
################################################################################
#         #                        #    #         #        #       #    #      #
#         #                        #    #         #        #       #    #      #
#         #                        #    #    #    #        #       #    #      #
###    ## #                        #    #    #    #####    #       #    #      #
#         #################    ### #    #    #    #        #       #    #      #
#         #                        #    #    #    #        #       #    #      #
#                                  #         #    #        #       #    #      #
#                                  #         #    #        #       #    #      #
#    #                     #       #         #    #        #       #    #      #
#    #                     #       #         #    #        #       #    #      #
#                                  #    #    #    #        #       #    #      #
############################    ## #    #    #    #        ###     #    #      #
#           #    #            #    #    #    #    #        #       #    #      #
#           #    #            #    #    #    #    #        #       #    #      #
#           #    #            #    #    #    #    #        #       #    #      #
#           #            #    #    #    #    #    #        #       #    #      #
#                        #    #    ##    ### #    #                #    #      #
#                             #    #         #    #                #    #      #
#                      ###### #    #         #    #                #    #      #
#                #      #     #    #         #    #                #    #      #
#           #    #      #     #    #         #    #        #       #    #      #
########    #### #      #     #    #         #    #        #       #    #      #
#    #           #      #     #    #    #    #    #        #       #    #      #
#    #           #      #     #    #    #    #    #        #       #    #      #
#    #           #      #     #    #    #    #    #                #    #      #
#    #           ###    #     #    #              #############    #    #      #
#                #      ##    #    #    ######### #        #       #    #      #
#                #            #    #              #        #       #    #      #
#                #            #    #              #                #    #      #
#                #            #    #                               #    #      #
#                #            #    #                               #    #      #
#                             #    #                               #    #      #
###########################   #    #   ########################### #    #      #
#              #     #        #    #          #         #          #    #      #
#              #     #        #    #          #                    #    #      #
#              #     #        #    #          #                    #    #      #
#              #     #        #    #               #               #    #      #
#     #              #        #    #               #          #### #    ####   #
#     #              #        #    #               #    #     #    #    #      #
#     ######         #        #    #   ########### #    #     #    #    #      #
#     #              #        #    #         #     #    #     #    #    #      #
#     #        #     #        #    #               #    #          #    #      #
#     #        #     #             #               #    #          #    #      #
#              #     #             #    #          #    ##         #    #      #
#######    ### #     #             #    #          #    #          #    #      #
#              #     #             #    #    #     #    #     #    #    #      #
#              #     #        #         #    #     #    #     #    #    #      #
#              #     #        #         #    #     #    #          #           #
#                    #        #         #    #     ###    ######## #           #
#######    ######### #        #         #    #     #    #     #    #           #
#     #       #      #        #    #    #    #     #    #     #    #           #
#     #       #      #        #    #    #####      #          #    #    #      #
#     #       #      #        #    #    #    #     #          #    #    #      #
#     #       #      #        #    #    #    #     #          #    #    #      #
#     #       #      #        #    #    #    #     #          #    #    #      #
#     #              ####     #    #    #          #    #     #    #    #      #
#     #              #        #    #    #          #    #          #    #      #
#     #              #        #    #    #          #    #          #    #      #
#     ##    ######## #        #    #    #*         #    #          #    #      #
###   #              #        #    #    #    #     #    ######     #    #      #
#                             #    #    #    #     #    #          #           #
#                             #    #    #    #     #    #          ########    #
#                             #    #    #    #     #    #          #           #
#                                  #                               #           #
###################################    ########################### #           #
#                                                           #      #           #
#                                                           #      #      ##   #
#                                                           #      #      #    #
#                                                           #      ###    #    #
#                           #                               #      #      #    #
#                           #                               #      #      #    #
#                                                           ###    #      #    #
#######################################################     #      #      #    #
#              #                                            #      #      #    #
#                                                                         #    #
#                                                                         #    #
#                                                                         #    #
#                                                                         #    #
################################################################################
