80 80
################################################################################
#             #          #     #       #                #      #               #
#                        #     #       #                #      #               #
#    #                   #             #                #                      #
#    #                   #             #                #                      #
#    ###############     #             #                                       #
#    #        #          #             #                                       #
#    #        #          #     #       #   ############# ##    #################
#    #                   #     #       #                                       #
#    #                   #     #       #                #                      #
#    #                   #     #       #                #                      #
#    #              #    #     #       #                                       #
#    #        #     #    #     #       ####    #################################
#    #        ##    #    #     #       #      #           #                #   #
#    #        #     #    #     #       #      #           #                #   #
#    #        #     #    #     #       #      #           #                #   #
#    ###      #     #    #     #       #      #     #     #                #   #
#    #        #     #    #     ##      #            #     #                #   #
#    #        #     #    #     #       #            #     #                    #
#    #        #          #     #       #    ##      #     #                    #
#    #        #   ###### #     #       #            #     #                    #
#    #        #     #    #     #              #           #########    #########
#    #        #     #    #     #              ########           #    #        #
#    #        #     #    #                    #                  #    #        #
#    #        #          ##    ########       #                       #        #
#    #        #          #    #        #      #                       #        #
#    #        #          #    #        #      #           #           #        #
#                        #    #        #######    ####### #####    ## #        #
##################    ## #    #        #        #         #      #    #        #
#     #    #        #    #    #        #        #         #   *  #    ####    ##
#     #    #        #    #    #        #        #         #      #    #        #
#     #    #        #    #    #        #                  #      #    #        #
#     #    #        #    #    #        #                  #      #    #        #
#     #    ######   #    #    #        #         ####     #   ## #    #        #
#     #    #        #    #    #        #                  #      #    #        #
#     #    #             #    ####     ###      #         #      #    #        #
#     #    #             #             #        #         #      #    #        #
#     #    #             #             #        #         #      #             #
#     #    ##########    #             #        #         #                    #
#     #          #       #             #        #         #                    #
#     #          #       #                                                     #
#     #          #             #################################################
#     #          #                                   #              #    #     #
#     #    #     #                                   #              #    #     #
#     #    #     #                                   #              #    #     #
#     #    #     #       #                           #        #     #    #     #
#          #     #       #######    #### #    ###### #        #     #    #     #
#          #     #       #               #                    #          #     #
#          #     #       #               #                    #          #     #
#          #     #       #               #                    #          #     #
#     #    #     #       #                                    #          #     #
#     #    #     #       #########################   #        #     #    #     #
#     #    #     #       #           #        #      #        ##    #    #     #
#     #    #     #       #           #        #      #        #     #    #     #
#     #    #     #       #           #               #        #     #    #     #
#     #    #     #       #           #               #        #     #    #     #
#     #    #     #       #           #               #        #     #    #     #
#     #    #     #       ########    ##    ######### #        #     #    #     #
#     #    #     #       #      #    #    #    #     #        #     #    #     #
#     #    #      ##     #           #    #    #     #        ####    ## #     #
#     #    #             #                #          #        #     #    #     #
#     #    #             #                #          #        #     #    ####  #
#     #    #             #                #          #    ### #     #          #
#     #    #     #       ##    ##         #   ###### #        #                #
#     #    #     #       #      #    #          #    #        #                #
#     #    #     #       #      #    #          #    #        #                #
#     #    #     #       #      #    #               #        #          #     #
#     #    #     #       #      #    #               #        ##    #    #     #
#     #    #     #       #      #    #    #          #        #     #    #     #
#     #    #     #       #      #    #    #          #        #     #    #     #
#     #    #     #       #                #                   #     #    #     #
#     #    #     #       ##############    ################## #     #    #     #
#     #    #     #       #                                    #     #    #     #
#          #     #       #                                    #                #
#    ##### #     #       #                                    #   ##############
#     #    #     #       #    #                               #      #         #
#          #     #       #    #                               #      #         #
#          #     #       #    #                               #                #
#          #     #       #    #                               #                #
################################################################################
