80 80
################################################################################
#        #       #                             #         #        #       #    #
#        #       #                             #         #        #       #    #
#   #    #       #                             #         #        #       #    #
#   #    #                                     #         #        #       #    #
#    ####                                      #    #    #        #       #    #
#                                                   #    #        #       #    #
#                                                   #    #        #       #    #
#         ###############    ##################     #    #        #       #    #
#   #    #                      #                        #        #       #    #
#   #    #                      #              #######   #        #    ## #    #
#   #    #                      #              #    #    #        #       #    #
#   #    #                                     #    #    #        #       #    #
#   #    #                                     #    #    ###      #       #    #
#   #    #                                     #    #    #        #       #    #
#                                              #    #    #        #       #    #
###################    ####################### #         #        #       #    #
#    #                 #       #               #         #        #            #
#    #                                         #         #        #            #
#                                              #         #        #            #
#              #                               #    #    #        #            #
#              #                ###    ####### #    #    #        #       #    #
#              ###########    ##               #    #    #        #       #    #
#              #               #               #    #             #       #    #
#              #               #               #    #             #       #    #
########    ## #               #               #    #             #       #    #
#              #                               #    #             #       #    #
#              ###################    ######## #    #    #        #       #    #
#              #                               #    #    #        #       ##   #
#              #                               #    #    #                #    #
#              #                               #    #    #                #    #
#                                                        #                #    #
###########    ######################################### #                #    #
#              #      #       #     #    #      #        #        #       #    #
#              #      #       #     #    #      #        #        #       #    #
#              #      #       #     #    #      #        #        #       #    #
#    #                #       #     #    #      #        #        #       #    #
#    #                #       #     #    #      #        #        #       #    #
#    #                        #     #    #               #                #    #
#    #                        #     #    #               ####    ######## #    #
#    #                        #     #    #               #           #    #    #
#    #####    ########        #     #    #########    ## #           #    #    #
#    #                #       #     #    #    #     #    #                #    #
#    #                #       #     #    #    #     #    #                #    #
#    #                #       #     #    #    #     #    ##    ######     #    #
#                     #       #     #    #    #     #    #     #          #    #
######    ########### #       #     #    #    #     #    #     #     #    #    #
#       #        #    #       #     #    #    #     #    #     #     #    #    #
#       #        #    #       #     #    #    #     #    #           #    #    #
#       #        #    #       #     #    #    #     #    #           #    #    #
#       #        #    #       #     #    #    #     #    #           #    #    #
#                #    #       #          #    #     #    #                     #
#                #    #       #          #    #     #    #############    ######
#                #    #    ## #          #          #    #     #      #        #
#                #    #       #          #          #    #     #      #        #
#       #        #    #  *    #     #               #    #     #      #        #
#       #    ### #    #             #               #    #     #      #        #
#       #        #    #             #               #    #     #      #    #   #
#       #        #    #             #     ##    ### #    #     #           #   #
#####   #             #             #    #     #    #    #     #           #   #
#       #             #       #          #     #    #    #     #           #   #
#       #             #       #    ##### #     #    #    #     #           #   #
#       #             #       #     #    #     #    #    #     #   ## #    #   #
#       #########     #       #          #     #    #    #     #      #####    #
#       #        #    #       #          #     #    #    #     #      #    #   #
#       #        #    #       #          #     #    #    #     #      #    #   #
#       #        #    #                  #          #    #     #      #        #
#       #        #    #    ############# #          #    #     #      #        #
#       #        #    #                  #          #    #     #      #        #
#       #        #    #                  #               #     #      #        #
#       #        #    #                  #               ###   #      #    #   #
#       #        #    #                                  #     #      #    #   #
#       #             ####################    ########## #            #    #   #
#       #             #                #                 #            #    #   #
#       #             #                #                 #                 #   #
#       ##    ###     #                #                 #      ##########    ##
#       #        #    #                                  #     #               #
#       #        #    #                                  #     #               #
#       #        #    #                                  #     #               #
################################################################################
