80 80
################################################################################
#                            #                  #    #    #       #     #      #
#                            #                  #    #    #       #     #      #
#                            #                  #    #    #       #     #      #
#                      #     ######    ######## #    #    #       #     #      #
#                      #     #           #      #    #    #       #     #      #
#                      #     #           #           #    #       #     #      #
#                      #     #                       #    #       #     #      #
#####################    ### #                       #    #       #     #      #
#      #       #      #      #                       #    #       #     #      #
#      #       #      #      #                       #    #       #     #      #
#      #       #      #      #                       #    #       #     #      #
#      #       #      #      ####    ############### #    #       #     #      #
#      #       #      #      #     #    #     #      #    #       #     #      #
#      #       #      #      #     #    #     #      #    #   ### #     #      #
#       ##     #      #      #     #    #     #      #    #       #     #      #
#              #      #      #     #    #     #      #    #       #     #      #
#              #      #      #     #    #     #      #    #       #     #      #
#              #      #      #     #    #     #      #    #       #     #      #
#  ### #       #      #      ###   #    ##    #      #    #       #     #      #
#      #       #      #      #     #    #     #      #    #       #     #      #
#      #       #      #      #     #    #            #    #       #     #      #
#      #       #      #      #     #    #            #    #       #     #      #
#      #       #      #      #     #    #      ##    #    #       #            #
#      #       #      #      #          #                         #            #
#      #       #      #      #          #     #                   #            #
#      #       #      #      #          #     #                   #            #
#      #       #      #      ####    ## #                         #     #      #
#      #       #      #      #           ######      #            #     #      #
#      #       #      #      #                #      ##    ###### #     #      #
#      #       #      #      #                #      #      #     #     #      #
#      #       #      #      #                #      #      #     #     #      #
#      #       #      #      ##    #    #     #      #      #     #     #      #
#      #       #      #      #     #    #     #      #            #     #      #
#      #       #      #      #     #    #     #      #            #     #      #
#              #      #      #     # *  #     #      #            #     #      #
###    ####### #      ###    #     #    #            ##      ##   #     #      #
#       #      #      #      #     #    #            #      #     #     #      #
#       #      #      #      #     #    #            #      #     #     #      #
#       #      #      #      #     #    #      ###   #      #     #     #      #
#       #      #      #      #     #    #     #      #      #     #     #      #
#       #      #      #      #     #    #     #      #      #     #     #      #
#       #      #      #      #     #    #     #      #      #     #     #      #
#    ## #      #      #      #     #    ##    #      #      #     #     #      #
#       #      #      #      #     #    #     #      #      #     #     #      #
#       #      #      #      #     #    #     #      #      #     #     #      #
#       #      #      #      #     #    #     #      #      #     #     #      #
#       #      #      #      #     #    #     #      #      #     #     #      #
#       #      #      #      #     #    #     #      #      #     #     #      #
#       #      #      #      #                                    #     #      #
#       #      #      #      ###########################    ##### #     #      #
#              ###    #      #                            #             #      #
#              #             #                            #             #      #
#              #             #                            #             #      #
#              #             #                 #          #             #      #
#       #      #             #                 #          #    ## #     #      #
#       #      ########    ##                  #          #       #     #      #
#       #             #                                   #       #     #      #
#       #             #       ######################      #       #     #      #
#       #             #           #                       #       #     #      #
#       #             #      #    #                       #       #     #      #
#       #      ####   #      #    #                               #     #      #
#       #      #      #      #    #                               #     #      #
#       #      #             #                                    #     #      #
#       #      #             #                                    #     ###    #
#                                                                 #     #      #
###############################################################   #     #      #
#                                  #                              #     #      #
#                                                                 #            #
#                                                                 #   ##########
#                                                                 #       #    #
####   #                                                          #       #    #
#      #################################    ##################### #       #    #
#      #                                                    #     #       #    #
#      #                                                    #     #    ###    ##
#      #                                                    #     #            #
#      #                                                          #            #
#      #                                                          #            #
#      #                                                          #       #    #
################################################################################
