80 80
################################################################################
#   #    #    #     #    #    #        #                    #    #       #     #
#   #    #    #     #         #        #                    #            #     #
#   #    #    #     #         #        #           #        #            #     #
#   #    #          #         #        #           #        #            #     #
#   #    #          #         #        #########    ####### #            #     #
#   #    #          #######   #        #      #        #    #    #       #     #
#   #    #     ##   #    #    #        #      #        #    #    #       #     #
#   #    #    #     #         #        #      #        #    #    #       #     #
#   #    #    #               #        #      #        #    #            #     #
#   #    #    #               #        #      #        #    ########     #     #
#   #    #    #               #        #      #        #    #      #     #     #
#   #    #    #               #        #      #        #    #      #     #     #
#   #    #    #   ########### #        #      #        #    #      #     #     #
#   #    #    #       #       #        #      #        #    #      #     #     #
#   #    #    #       #       #        #      #        #    #      #     #     #
#   #    #    #       #       #        #      #        #    #      #     #     #
#   #    #    #       #       #        ###    #             #      #     #     #
#   #    #    #        ###    #        #      #             #      #     #     #
#   #    #    #               #        #      #             #      #     #     #
#   #    #    #               #        #      #             #      #     #     #
#   #    #    #               #        #      #        #    #      #     #     #
#   #    #    ###    ##       #        #      #    ### #    #            #     #
#   #    #    #       #       #        #      #        #    #            #     #
#   #    #    #       #       #        #      #        #    #            #     #
#   #    #    #       #       #        #      #        #    #            #     #
#   #    #    #       #       #        #      #        #    #      ##    #     #
#   #    #    #       #       #               #        #    #      #     #     #
#   #    #            #       #               #        #    #      #     #     #
#   #    ##########    ###### #               #        #    #      #     #     #
#   #    #    #    #    #     #               #        #    #      #           #
#   #    #    #    #    #     #        #      #             #      #           #
#   #    #    #    #    #     #        #      ##########    #      #           #
#   #    #    #    #    #     #        #      #     #       #      #           #
#   #    #    #    #    #     #        #      #             #      #     ###   #
#        #    #         #     #        #      #                    #     #     #
#        #    #         #     #        #      #                    #     #     #
#        #    #         #     #        #      #           ##       #     #     #
#        #    #         #     #        #            #              #     #     #
#   #    #    #    #    #     #        #            #       #                  #
#   #    #    #    #    #     #        #            #       #    ###############
#        #    #    #    #     #        #            #       #       #          #
######   #    #    #    #     #        #      #     #       #       #          #
#   #    #    #    #    #     #        #      #     #       #                  #
#   #    #    #         #     #        #      #     #       #                  #
#   #    #     #####    #              #      #     #       #                  #
#   #    #         #    #              #      #     #       #                  #
#   #    #         #    #              #      #     #       #                  #
#   #    #         #    #              #                                       #
#   #    #    #    #    #     #        #################    ####################
#   #    #    #         #     #        #  *  #                #         #      #
#        #    #         #     #        #     #                #         #      #
#        #    #         #     #        #                      #                #
#        #    #         #     #        #                      #    #           #
#        #    #    #    #     #        #                           #        ####
#   #    #    #    #    #     #        #                           #           #
#   #    #    #    #    #     #        #                           #    #      #
#   #    #    #    #    #     #        ##############    ##### ####     #      #
#   #    #    #    #    #     #        #       #              #         #      #
#   #    #    #    #    #     #        #       #              #         #      #
#   #    #    #    #    #     #        #                      #         #      #
#   #    #    #    #    #     #        #                      #         #      #
#   #    #              #     #        #                                #      #
#   #    ######    #### ###   #   #### ###################    ######### #      #
#   #    #         #    #     #        #             #                  #      #
#   #    #                    #        #             #                  #      #
#   #                         #        #             #                  #      #
#   #                         #        #             #                  #      #
#   #     ####                #        ##########    #                  #      #
#   #              #    #     #        #              ############      #      #
#   #    #         #    #     #        #                      #         #      #
#   #    #         #    #     #        #                                #      #
#                       #     #        #                                #      #
#####################    #### #        #                                #      #
#                             #                                                #
#                             #################################    #############
#                             #                                                #
#                        #    #                                                #
#                        #    #                                                #
################################################################################
