80 80
################################################################################
#       #    #         #         #        #        #    #               #      #
#       #    #         #         #                 #                           #
#       #    #         #         #                 #                           #
#       #    #              #    #                 #                           #
#            #    #         #    #                 #                           #
#             #####     ##    ## #        #        #    #####    ###############
#                                    #### #        #    #        #             #
#                      #                  #        #    #                      #
#       #              #                  #        #    #                      #
#       #    #                            #             #                  #   #
#  #### #    #################   #        #             ####      ###      #   #
#       #    #            #      #        #             #        #         #   #
#       #    #            #      #        #             #        #         #   #
#       #    #            #      #        #        #    #        #         #   #
#       #    #       #    #      #        #        #    #        #         #   #
#       #    ###     #    #      #        #        #    #        #         #   #
#       #    #       #    #      #        #        #    #        #         #   #
#       #    #       #    #      #        #        #    #        ########    ###
#       #    #       #    #      #        #####    #    #        #      #      #
#       #    #       #    #      #        #        #    #        #      #      #
#       #    #       #    #      #        #        #    #        #      #      #
#       #    #            #      #        #        #    #        #      #      #
#       #    ##########   #      #        #        #    #        ##     #      #
#       #    #    #       #      #        #        #    #        #      #      #
#       #    #    #       #      #                 #    #        #      #      #
#       #    #    #       #      ###########    ## #    #        #      #####  #
#            #    #       #      #                 #    #        #      #      #
#  ######### #    #       #      #                 #    #        #      #      #
#      #     #    #       #      #                 #    #        #      #      #
#      #     #    #       #      #                      #        #      #      #
#      #     #    #       #      ####################   #        #      #      #
#      #     #    #       #   ## #     #    #    #      #        #      #      #
#            #    #   ### #      #     #    #    #      #        #      #      #
#            #    #       #      #     #    #    #      #        #      #      #
#  ####      #            #      #     #                #        #      #      #
#            #                   #                      #        #      #      #
#      #     #                   #                      #        #      #      #
#      #     #                   #                      #        #      #      #
#                                ####    ## #           #        #      #      #
####################    ######## #     #    #           #        #      #      #
#    #         #    #       #    #     #    #   ####### #        #      #      #
#    #         #    #       #    #          #           #        #      #      #
#    #              #       #    #          #           #        #      #      #
#         #         #       #    #          #           #        #      #      #
#         #         #       #    #          #           #        #      #      #
#         #         #       #    #     #    #      #    #        #             #
#  ##     ##    ####        #    #     #    #      #    #        #             #
#    #    #    #            #    #     #                                       #
#    #    #    #            #    ###    ########################################
#    #    #    #            #    #                            #    #      #    #
#    #    #    #    #       #    #                                 #      #    #
#    #    #    #    #       #    #                                 #      #    #
#    #    #    #    #       #    #                                 #      #    #
#    #    #    #    #       #    #                                 #      #    #
#    #    #    #    #       #    #                                 #      ##   #
#    #    #    #    #       #    #                                 #      #    #
#         #    #    #       #    ##########    ################### #      #    #
#    #### #    #    ###          #      #                          #      #    #
#    #    #    #    #            #      #                          ####   #    #
#    #    #    #    #            #      #                          #      #    #
#    #    #    #    #            #      #              #           #      #    #
#    #    #    #    #            #      #              #                  #    #
#    #    #    #    #            #      #                                      #
#    #    #    #    ####    #### #      #######################                #
#    #    #    #    #      #     ####   #    #                                 #
#    #    #    #    #      #     #      #                          #           #
#    #    #    #    #      #     #      #                          #      #    #
#    #    #    #    #      #     #      #           #              #      #    #
#    #    #    #    #      #     #      #           #####    ##### #           #
#    #    #    #    #      #     #      #####    ## #    #         #   #########
#         #    #    #      ##    #           #      #    #         #      #    #
#         #         #      #     #           #      #    #         #      #    #
#         #         #      #     #                  #    #         #           #
#                   #   ###      #                  #     #####    #           #
#####    ########## #            #      #           #         #    ###         #
#                   #            #      #           #              #      *    #
#                   #            #      #    #      #              #      #    #
#                   #      #     #      #    #      #    #         #      #    #
################################################################################
