80 80
################################################################################
#                   #       #     #    #              #    #     #             #
#                   #       #     #    #              #    #     #             #
#                   #       #     #    #              #    #     #             #
#####    ########## #       #     #    #              #    #                   #
#    #              #       #          ############   #    #                   #
#    #              #       #          #     #        #    #                   #
#    #              #       #          #     #             ########    #########
#    #              #       #          #     #             #       #     #     #
#    ###########    #       #     #    #     #             #       #     #     #
#    #       #      #             #    #     #             #       #     #     #
#    #       #      #             #    #     #        #    #       #     #     #
#    #       #      #   ####      #    #     #        #    #       #     #     #
#    #       #      #             #          #        #    #       #     #    ##
#    #       #      #       #                #        #    #       #     #     #
#            #      #       ##    #####       ###     #    #       #     #     #
#     ###    #      #       #     #                   #    #       #     #     #
#            #      #       #     #    #              #    ##    ##      #     #
#            #              #     #    #              #    #             #     #
#    #       #              #     #    #     #        #    #             #     #
#    #       #              #          #     #        #    #             #     #
#    #       #              #          #     #        #    #       #     #     #
#    #       #      #       #          #     #        #    #       #     #     #
#    #       #      #       #          #     #        #    #       #           #
#    #       #      #       #     #    #     #             #       #           #
#    #       #      #       #     #    ######    ######### #       #           #
#    #       #      #       #     #    #     #     #       #       #           #
#    #       #      #                  #     #     #       #       #     #     #
#    #       #      ################   #           #       #       #     #     #
#    #       #      #        #         #           #       #       #     #     #
#    #       #      #        #         #           #       #       #     #     #
#    #       #      #        #         ##    ##### #       ########      #     #
#    #       #      #        #         #    #      #       #       #     #     #
#    #       #      #        #         #    #      #       #       #     #     #
#    #       #      #        ####      #    #      #       #       #     #     #
#    #              #        #         #    #      #       #       #     #     #
#    #              #####    #         #    #      #       #       #     #     #
#    #              #        #         #    #      #               #     #     #
#    #        ###   #                  #    ###    #               #     #     #
#    #       #      #                  #    #      #               #     #     #
#    #       #      #                  #    #      #               #     #     #
#    #       #      #                  #    #      #       #       #     #     #
#    #       #      #        #         #    #      ##      #       #     #     #
#    #       #      #        #         #    #      #       #####         #     #
#    #       #      #        #         #    #      #       #             #     #
#    #       #      #        #         #           #       #             #     #
#    #       #      #        #         #                   #             #     #
#                                      #                   #             #     #
################################    ## #                                       #
#      #     #     #      #    #       ######    ###############################
#      #     #     #      #    #       #     *   #       #           #         #
#      #     #            #    #       #         #       #           #         #
#            #            #            #         #       #                     #
#            #            #            #         #       #                     #
#            #            #            ###    ## #####   #                     #
#            #   #########             #                 #                     #
#            #                 #       #                 #                     #
#########    #                 #       #                 #####    ##############
#   #        #                 #   ### #                 #         #    #      #
#            #                 #       ###    ########## #         #    #      #
#            #######    ###### #       #       #         #         #    #      #
#            #    #            #       #       #         #         #    #      #
#                 #            #       #       #         #    #    #    ###    #
#   ###    ##     #            #       #       #         #    #         #      #
#   #                          #       #       ###    ## #                     #
#   #                          #       #       #    #    #    #####            #
#   #                          #       #       #    #    #                     #
#                              #       #       #    #              #    ########
####################    ###### #       #       #                   #    #      #
#     #                        #       #       #                   #    #      #
#                              #       #       #              #    #    #      #
#                              #       #       #         #    #    #    #      #
#                        #     #       #       #    #    #    #    #    #      #
#                   #    #     #       #   ### #    #    #    #    #    ##    ##
#########    ###### #    #     #       #       #    #    #    #    #    #      #
#                   ###    ### #       #       #    #    #    #    #    #      #
#                   #          #       #            #    #    #    #           #
#                   #          #       #            #    #    #    #           #
#                   #          #       #            #    #    #    #           #
################################################################################
