80 80
################################################################################
#    #             #               #    #               #    #    #     #      #
#    #             #               #    #               #    #    #     #      #
#    #             #               #    #               #         #     #      #
#    #                             #    ######    ##### #         #     #      #
#    #                             #    #       #       #         #     #      #
#    #                             #    #       #       #         #     #      #
#    #                             #    #               #    #    #     #      #
#    ###################    ###### #    #                    #    #     #      #
#    #                     #            #                         #     #      #
#    #                     #            #                ######   #     #      #
#    #                     #            #       #            #    #     #      #
#    #                                  #       #    ## #    #    #     #      #
#    #                             #    #    ## #       #    #    #     #      #
#    #                             #    #       #       #    #    #     #      #
#    #                                  #       #       #         #     #      #
#    ###########    ################### #       #       #         #     #      #
#    #        #     #      #      #     #       #       #         #     #      #
#    #        #            #      #     #       #       #         #     #      #
#    #        #            #      #     #                         #     #      #
#    #        #            #      #     ##################    ### #     #      #
#    #        #            ####   #     #                         #     #      #
#    #        #     #      #      #     #                         #     #      #
#    #        ###   #      #            #                         #     #      #
#             #     #      #            #                    #    #     #      #
#             #     #      #            ####    ############ #    #     #      #
#             #     #      ####    #### #                    #    #     #      #
#             #     #      #      #     #                    #    #     #      #
#    #        #     #      #      #     #                    #          #      #
#    ###      #     #      #      #     #        #           #          #      #
#    #        #     #      #      #     #        #           #          #      #
#    #        #     #      #      #     #        #                      #      #
#    #        #     #      #      #     ######    ##################### #      #
#    #        #     #             #     #       #    #                  #      #
#    #        #     #                   #       #    #                  #      #
#    #              #                   #       #    #                  #      #
#    #              #                   #            #        #         #      #
#    #              #      #            #            #        #                #
#    ######    #### #      #      #     #####        #        #                #
#    #    #    #    #      #      #     #            #        #                #
#    #    #    #    #      #      #     #       #    ######    #########       #
#    #    #    #    #      #      #     #       #          #    #     * #      #
#    #    #    #    #      #      #     #                  #    #       #      #
#    #    #    #    #      #      #     ####    #####      #    #       #      #
#    #         #    #      #      #     #                  #            ###    #
#    #         #    #      #      #     #            #     #            #      #
#    #         #    #      #      #     #            #           ####   #      #
#    #         #    #      #      #     #     #      #                  #      #
#    #    #    #    #      #      #     #     #      #          #       #      #
#    #    #    #    #      #      #     #     ##     #          #       #      #
#    ##    ### #    #      #      #     #     #      #     #            #      #
#    #    #    #    #      #      #     #     #      #     ##########   #      #
#    #    #    #    #      #      #     #     #      ###   #            #      #
#    #    #    #    #      #      #     #     #      #     #            #      #
#    #         #    #      #      #     #     #      #     #            #      #
#    #         #    #      #      #     #     #      #     #            #      #
#    #         #    #      #      #     #                  #                   #
#    #         #    #             #     ################    ####################
#    #    #    #    #############    ## #                      #               #
#    #    #    #    #    #         #                           #               #
#    #    #    #    #    #         #                           #               #
#    #    #    #    #                        #                 #               #
#    #    #    #    #                        #         #                       #
#    #    #    #    #                   #    ##    ### #                       #
#    #    #    #    #     #######    ## #    #    #    #                       #
#    #    #    #    #    #              #    #    #    ###########    ##########
#    #    #         #    #              #    #    #    #                       #
#    #    #         #    #              #    #    #    #                       #
#    #    #         #    #              #    #    #    #                       #
#    #    #         #    #     #        #    #    #    #      #                #
#    #    #         #    #     #        #    #    #    #      ###    ###########
#                                       #    #         #      #            #   #
#   ################################### #    #         #      #                #
#                               #       #    #         #      #                #
#                               #       #              #      #                #
#                               #       #    ######### #      ####    #####    #
#                               #       #              #      #            #   #
#                                       #              #      #            #   #
#                                       #              #      #            #   #
################################################################################
