80 80
################################################################################
#       #    #    #                  #           #     #                       #
#       #    #    #                              #     #                       #
#       #    #    #                              #     #                       #
#       #    #    #                              ###    ###########    #########
#       #    #                                   #              #              #
#       #    #                                   #              #              #
#       #    #     ##########################    #              #              #
#            #           #      #    #           #     #                       #
#            #    #      #      #    #           #     #                       #
#                 #      #      #                #                             #
#                 #      #      #                ######################    #####
#       #         #      #      #         #      #      #         #       #    #
#       #         #      #      #         #      #      #         #       #    #
#       #    #    #      #      #    #    #      #      #         #       #    #
#       #    #    #      #      #    #    #      #      #                 #    #
#       #    #    #      #      #    #    ####   #      #                 #    #
#       #    #    #      #      #    #    #      #      #                 #    #
#       #    #    #      ###    #    #    #      #      #                 #    #
#       #    #    #      #      #    #    #      #      ########    ##### #    #
#       #    #    #             #    #    #      #      #       #         #    #
#       #    #    #             #    ##    ##### #      #       #         ##   #
#       #    #    #             #    #      #    #      #       #         #    #
#       #    #    #             #    #           #      #                 #    #
#       #    #    #      #      #    #           #      #            #    #    #
#       #    #    #      #      #    #           #      #####        #### #    #
#       #    #    #      #      #    #           #      #                 #    #
#       #    #    #             #    #           #      #       #         #    #
#       #    #    ########      #    #           #      #       #         #    #
#       #    #    #       #     ##    ########## #      #       #              #
#       #    #    #       #     #      #    #    #      #       #              #
#       #    #    #       #     #      #    #    #      #                      #
#       #    #    #       #     #      #    #           ####################   #
#       #    #    #       #     #      #    #           #                #     #
#       #    #    #       #     #                       #                #     #
#       #    #    #             #                 ###   #                #     #
#       #    #    #             #                #      #                #     #
#       #    #    #             #                #                       #     #
#       #    #    #              ##    #         #       ####    ########     ##
#       #    #    #       #            #         #                  #          #
#       #    #    #       #            #    #### #                  #          #
#       #    #    #       #   ##       #    #    #      #                      #
#       #    #    ###     #     #      #    #    #      #                #     #
#       #    #    #       #     #      #         #      #                #     #
#       #    #    #       #     #      #         #      #                #     #
#       #####     #       #     #      #         #      #                #     #
#       #    #    #                                                            #
#       #    #    #######################################    ###################
#       #    #    #     #    #       #    #    #                        #      #
#       #    #    #     #    #       #         #                        #      #
#####   #    #    #     #    #                 #                        #      #
#       #    #    #          #                 #                               #
#       #    #    #          #                 #                               #
#       #    #    ###        ##    ## ######                                   #
#       #    #    #          #       #                                         #
#       #    #    #     #    #       #          ########    ####################
#       #    #    #     #    #       #                                         #
#       #    #    #     #    #                 #                               #
#       #    #    #     #    ##########    ### #                               #
#       #         #     #    #                 #                               #
#       #         #     #    #                 ######    ########### ####    ###
#       #         #     #    #                 #                     #         #
#       #         #          #            #    #                     #         #
#       #    #    #   ###### #            #    #                     #         #
#       #    #    #     #    #                                                 #
#       #    #    #     #    ######    #########################################
#       #    #    #     #    #                                   #       #     #
#       #    #    #     #    *                                   #       #     #
#            #    #     #                                        #       #     #
##########    ### #     #                                        #             #
#    #            #     #     ###############################                  #
#    #            #     #    #             #                                   #
#    #            #     #    #             #                                   #
#    #            #     #    #             #                                   #
#  ## ###    #### #     #    #             #                     ########    ###
#            #    #     #    ####    ##### ##############    ### #     #       #
#            #    #          #             #                     #     #       #
#                 #          #                                   #             #
#    #            #          #                                   #             #
################################################################################
