80 80
################################################################################
#    #    #     #    #           #      #                  #      #    #       #
#         #     #                #      #                  #      #    #       #
#         #     #                #      #      #           #      #    #       #
#         #     #          ##### #      ####   ######      #      #    #       #
#         #     #          #     #             #           #   ## #        #####
#    #    #     #    #     #     #             #           #      #            #
#    #    #     #    #     #     #             #           #      #            #
#    #    #          #     #     #             #           #      #            #
#    #    #          #     #     #      #######    ####### #      #    #       #
#    #    #          #     #     #      #           #      #      #    #       #
#    #    #          #     #     #      #                  #      #    #       #
#    #    #     #    #     #            #                         #    #       #
#    #    #     #    #     #            #                         #    #       #
#    #    #     #    #                  ######    ## ###          #    #       #
#    #    #     #    #                  #           #                   ########
#    #    #     #    #      ##   #      #           #      #                   #
#    #    #     #    #           #      #           #      #                   #
#    #    #     #    #     #     #      #                                      #
#    #    #     #    #     #     #      #####    ################ #       #    #
#    #    #     #    #                  #               #         #       #    #
#    #    ######     ###############    #               #         #####   #    #
#    #    #          #                  #               #         #       #    #
#    #    #          #                  #                         #       #    #
#    #    #          #                  #                         #       #    #
#    #    #                             #                                      #
#    #    ###########################   #############################    #######
#    #    #                             #                                      #
#    #    #                             #                                      #
#    #    #                             #                                      #
#    #    #                      #      #                                      #
#    #    #                      #      #                            #         #
#    #    #                      #      #                            #         #
#    #    #                                                                    #
#    #    ###############################    ###################################
#    #    #          #                     #        #     #     #         #    #
#    #    #          #                     #              #     #         #    #
#    #    #                                #              #     #              #
#    #    #                           #    #                    #              #
#    #    #                           #    #                    #              #
#    #    #                           #    #        #           #              #
#    #    #################    ###### #    #        #           #              #
#    #    #          #    #     #     #    #        ##    ##### #              #
#    #    #          #    #     #     #    #        #     #     ####    ########
#    #    #          #    #     #     #    #        #           #     #        #
#    #    #          #    #     #     #    #        #           #     #        #
#    #    ####    ## #    #     #     #    #        #           #              #
#    #    #          #     ##   #     #    #        #           #              #
#    #    #          #          #     #    #        #     #     #   ##      ####
#    #    #          #          #     #    #        #     #     #              #
#    #    #          #                #    #        #     #     #     #        #
#    #          #    #    #           #    #        #     #           #        #
#    #          #     #####           #    #        #     #           #        #
#    #     ##   #                     #    #        #                          #
#    #          #               #     #    #        #############    ###########
#    #    #     #               #     #    #        #     #     #    #         #
#    #    #     #               #     #    #        #     #     #    #         #
#    #    #                     #     #    #        #           #    #         #
#    #    #   ################# #     #    #        #           #              #
#    #    #                     #     #    #        #           #              #
#    #    #                     #     #     #####   #           #              #
#    #    #                     #     #             #           #              #
#         #    #                #     #             #           #########    ###
######    #    ##    ########## #     #             ########    #      #       #
#         #    #           #    #     #    #        #      #    #      #       #
#         #    #                #     #    #        #      #    #              #
#         #    #                #     #    #        #      #    #              #
#   #     #    #                #     #    #        #           #    *         #
#   #     #    #                #     #    #        #           #              #
#   #     #    #                #     #    #        #    ##     #      ######  #
#   #     #                                #        #           ###    #       #
#   #     #   ############################ #        #      #    #      #       #
#   #     #                       #        #        #      #           #       #
#   ###   #                       #        #        #      #           #       #
#   #     #                       #        #                                   #
#   #     #                       #        ########################    #########
#   #     #                                #                                   #
#   #     #                                #                                   #
#   #     #                                #                                   #
################################################################################
