80 80
################################################################################
#       #            #       #                                     #       #   #
#       #            #       #                                     #           #
#       #            #       #                                     #           #
#       #            #       #                                     #           #
#       #                    ###########################    ####### ###    #####
#       #                    #                                                 #
#####   #                    #                                                 #
#       #   ################ #                                                 #
#       #        #     #     #                                                 #
#       #        #     #     #                                                 #
#       #        #     #     #######################################    ########
#       #        #     #     #      #      #    #    #             #    #      #
#       #                    #      #      #    #    #             #    #      #
#       #                    #      #      #    #    #             #    #      #
#       ######               #      #      #    #    #             #           #
#       #              ##### #      #      #         #             #           #
#       #        #           #      #      #         ###########               #
#                #           #      #      #         #                         #
#                #           #      #      #         #                  #      #
#                #           #      #      #    #    #                  #      #
#                #    #      #      #      #    #    #                  #      #
#       #        #    #      #      #      ##    ### ############    ## #      #
#       #        #    ####   #      #      #    #    #             #    #      #
#       #        #    #      #      #      #    #    #             #    #      #
#       #        #    #      #      #      #    #                  #    #      #
#       #        #    #      #      #      #    #                  #    #      #
#                     #      #      #      #    #                       #      #
###################    ##### #      #      #    #                       #      #
#    #           #     #     #      ###    #    #    #                  #      #
#    #           #     #     #      #                #                  #      #
#    #           #     #     #      #                #                  #      #
#    #           #     #     #      #                                   #      #
#    #######     #     #     #      #       ########################    #      #
#    #     #     #     #     #      #      #               #     #      #      #
#    #     #     #     #     #      #      #                     #      #      #
#    #     #     #     #     #      #      #                     #      #      #
#    #     #           #     #             #                     #      #      #
#    #     ##          #     #             #                     #      #      #
#    #     #           #     #    ##       #               #     ####   #      #
#    #     #      ##   #     #             #########    ## #     #      #      #
#    #     #     #     #     #      #      #     #         #     #      #   ####
#    #     #     #     #     #      #      #               #     #      #      #
#    #     #     #     #     #      #      #               #     #      #      #
#    #     #     #           #      #      #               #     #      #   *  #
#    #     #     #           #      #      #               #     #      #      #
#    #     #     #      ##   #      #      #               #     #      #      #
#    #     #     #           #      #      #                     #      #      #
#    #     #     #     #     #      #      ############    ##### #      #      #
#    ###   #     #     #     #      #      #                     #      #      #
#    #     #     #     #     #      #      #                     #      #      #
#    #     #     #           #      #      #                     #      #      #
#    #     #     #########   #      #      #      #              #      #      #
#    #     #     #           #      #      #      #                     #      #
#          #     #           #      #      #      #      #              #      #
#          #     #           #      #      #      ########    ###       #      #
#          #     #    #      #      #      #      #                     #      #
#                #    #             #      #      #              #      #      #
#    #           #    #             #      #      #              #      #      #
#    #                              #      #      #              #      #      #
#    ######    ##############       #      #      #              #      #      #
#    #              #        #             #                                   #
#    #              #        #    ######## ################################    #
#    #              #        #       #     #    #              #               #
#    #                       #       #     #                   #               #
#    #                       #       #     #                   #               #
#    #        #              #       #     #                   #         #     #
#    #        #              #       #     #                   ####      ####  #
#    #        #     #        #       #     #                   #         #     #
#    #        #     ###      #       #     #                   #         #     #
#    ####     #     #        #             ###############     #         #     #
#    #        #     #        #             #                   #               #
#    #        #     #        #   ####      #                       #############
#    #        #     #        #             #                                   #
#    #              #        #       ##    #                                   #
#    ####    ###### #        #       #     #######    #    ####                #
#    #              #        #       #     #          #        #               #
#    #              #        #       #     #          #        #       #       #
#    #              #        #       #     #          #        #       #       #
################################################################################
