80 80
################################################################################
#             #          #    #      #        #          #                     #
#                        #    #      #                   #                     #
#                        #    #      #                   #                     #
#                        #    ##     #                           #             #
#                        #           #                           #             #
################    #### #           #######    #########        #             #
#      #     #     #     #           #          #                              #
#      #     #     #     #           #          #        #    ##################
#      #     #     #     #           #          #        #            #        #
#      #     #     #     #   ####### #          #        #                     #
#      #     #     #     #     #     ###    ### ####     #                     #
#      #     #     #     #     #     #          #        #                     #
#      #     #     #     #     #     #                   #                     #
#      #     #     #     #     #     #                   #                     #
#      #     #     #     #     #     #                                         #
#            #     #     #     #     #########    ##############################
#            #     #     #     #     #               #                         #
#            #     #     #     #     #               #                         #
#            #     #     #                           #                         #
###    #     #     #     #                           #                         #
#      #     #     #     #                                                     #
#      #     #     #     #                                                     #
#      #     #     #     #                                                     #
#      #     #     #     #######################    ############################
#      #     #     #     #    #      #      #      #       #      #     #      #
#      #     #     #     #    #      #      #      #       #      #     #      #
#      #     #     #     #    #      #             #       #      #     #      #
#      #     #     #     #    #      #             #       #            #      #
#######      #     #     #    #      #             #       #            #      #
#    #       #     #     #    #      #             #       #            #      #
#    #       #     #     #    #      #      #      #       #            #      #
#    #       #     #     #    #      #      #      #       #######      #      #
#    #       #     #     #    #      #####    #### #       #     #      #      #
#    #       #     #     #           #      #      #       #     #      #      #
#    #             #     #           #      #      #       #     #      #      #
#    #             #     #           #      #      #       #     #      #      #
#    #             #     #           #      #      #       ###   #      #      #
#    #             #     #    #      #      #      #       #     #      #      #
#    #       #     #     #    #      #      #      #       #     #      #      #
#    #       #     #     #    #      #      #      #   ### #     #      #      #
#            #     #     #    #      #      #      #       #     #      #      #
#            #     #     #    #      #      #      #       #     #      #      #
#            #     #     #    #      #      #      #       #     #      #   ####
#            #     #     #    #      #      #      #       #     ##            #
#    #       #     ###   #    #             #      #       #     #             #
#    #       #     #     #    #             #      #       #     #             #
#    #       #     #     #    #             #      #             #             #
#    #       #     #          #             #      #             #      #      #
#    #       #     #          #      #      #      #             #      #      #
#    #       #     #          #      #      #      #             #      #      #
#    #       #     #          #      #             #       #     #      #      #
#    #       #     #     #    ##     #             #       #     #      #      #
#    #       #     #     #    #      #             #       #            #      #
#    #       #     #     #    #      #             #       #            #      #
#    #       #     #     #    #      #      #              #                   #
#    #       #     #     #    #      #      ##             ########    #########
#    #       #     #     #    #      #      #              #    #         #    #
#    #       #     #     #    #      #      #              #    #         #    #
#    #       #     #     #    #      #      #              #    #         #    #
#    #       #     #     #           #                     #    #         #    #
#    #       #     #     #########   ###################   #    #######   #    #
#    #       #     #     #           #                     #              #    #
#    #       #     #     #           #                     #              #    #
#    #       #     #     #           #                     #              #    #
#    #       #     #     #      #    #             #     * #         #    #   ##
#    #    ## #     #     #      #    #             #       #         #    #    #
#    #       #     #     #      #    #             #       ##########     #    #
#    #       #     #     #      #    #             #       #      #       #    #
#    #       #           #                                 #      #       #    #
#    #       #           ##############    ############### #      #       #    #
#    #       #           #                 #               #      #            #
#    #       #           #                 #               ##    ##            #
#    #       ########    #                 #               #                   #
#    #       #     #     #                                 #                   #
#    #       #     #     #                                 #           ## #    #
#    #       #           #                                 #              #    #
#    #       #           #                                 #      #       #    #
#    #       #           #                 #               #      #       #    #
################################################################################
