80 80
################################################################################
#    #             #     #      #     #      #                     #           #
#    #             #     #      #     #                            #           #
#    #             #            #     #                                        #
#    ###   #       #            #     #                                        #
#    #     #       #            #     #                             #########  #
#    #     #       #            #     ###################    ######            #
#    #     #       #            #     #                            #           #
#    #     #       ######    ###      #                            #           #
#    #     #       #                  #                            #           #
#    #     #       #                  #                                        #
#    #     #       #                  #####################################    #
#    #     #       #            #     #    #     #         #    #    #     #   #
#    #     #       ##############     #    #     #         #    #    #     #   #
#    #     #       #     #    #       #    #     #         #    #    #     #   #
#    #     #       #     #    #       #          #         #    #    #     #   #
#          #       #     #    #       #          #         #    #    #     #   #
#          #       #     #    #       #          #         #    #    ###   #   #
#          #       #     #    #       #     ##   #         #    #    #     #   #
#          #       #     #    #       #    #     #         #    #    #         #
########   #       #     #    #       #    #     #         #    #              #
#   #      #       ##    #    #       #    #     #         #    #              #
#   #      #       #     #    #       #          #         #    #              #
#   #      #       #     #    #       ######               #    #          #####
#   #      #       #     #            #     #              #    #    #     #   #
#   #      #       #     #            #     #              #    #    #     #   #
#   #      #       #     #            #     #     ###      #    #    #     #   #
#   #      #       #     #            #     #    #         #    #    #     #   #
#   #      #       #          #       #     #    #         #    #    #     #   #
#   #      #       #          #       #     #    #         #    #    #     #   #
#   #      #       #          #       #     #    #         #    #    #     #   #
#   #      #       #          #       #     #    #         #    #    #     #   #
#   #      #             #    #       #     #    #         #    #    #     #   #
#   #      #             #    #       #     #    #         #    #    #     #   #
#   #      #        #####     #       #     #    #              #    #     #   #
#   #      #            #     #       #          #                   #     #   #
#   #      #       #          #       #          #                   #     #   #
#   #      ####    #          #       #                              #     #   #
#   #      #       #          #       ##################   #         #     #   #
#   #      #       #          #       #    #     #         #    #    #     #   #
#   #      #       #    #     #       #    #     #         #    #    #     #   #
#   #      #       #    #     #       #          #         #    #    #     #   #
#   #      #       #    #     #    ## #          #    #    #    #    #     #   #
#   #      #       #    #     #       #          #    #    #         #     #   #
#   #      #       #    #     #       ###    #### ##    ## #######   #     #   #
#   #      #       #    #     #       #    #               #    #    #     #   #
#   #      #       #    #     #       #    #               #    #    #     #   #
#   #      #                          #    #               #    #    #     #   #
#   #      ###############    ####### #    #     #         #    #    #     #   #
#          #             #            #    #     #    #    #    #    #     #   #
#          #             #            #    #     #    #    #    #    #     #   #
#          #                          #    #     #    #    #         #     #   #
#          #                          #          #    #    #         #     #   #
#   #      #                          #          #    #    #         #     #   #
#   #      #                          #                              #     #   #
#                                     #################    ######### #     #   #
#############    #####################                     #    #    #     #   #
#                                                          #    #    #     #   #
#                                                          #    #    #     #   #
#                                                          #    #    #     #   #
#    #                                #                    #    #    #     #   #
#    ############################     #                         #    #     #   #
#    #      #            #       #    #                         #    #     #   #
#    #                   #       #    #                         #    #     #   #
#    #                   # *     #    #############    ######## #    #         #
#    #                   #            #    #     #       #      #    #         #
#    #                   #            #    #     #                   #         #
#    #                   #            #    #     #                   #         #
#    #    ############## #            #          #                   #     #   #
#    #     #             #       #    #                              #     #   #
#    #     #             #####   #    #                  #      #    #     #   #
#    #                   #       #    #                  #      #    #     #   #
#    #                   #       #    ###    ####        #      #    #     #   #
#    #          ######## #       #    #    #     ########    ## #    #     #   #
#    #            #      #       #    #    #     #              #    #     #   #
#    #    ##      #      ######    ## #    #     #              #    #     #   #
#    #     #      #      #            #          #              #    #     #   #
#    #     #                          #          #              #    #     #   #
#    #     #                          #          #              #    #     #   #
################################################################################
