80 80
################################################################################
#               #    #      #      #    #    #    #               #    #       #
#               #    #      #      #         #    #               #    #       #
#               #    #      #                #                    #    #       #
#########    ## #           #                #          ####      #    #       #
#               #           #                #         #    #     #    #       #
#                           #           #    #   ##### #    #     #    #       #
#                           ###    #    #    #    #    #          #    #       #
#                    #             #    #    #         #          #    #       #
#                    #             #    #    #         #          #    #       #
##    ############## #             #    #    #         #          #    #       #
#   #                #             #    #    #                    #            #
#   #                #      #      #    #    ###    ############# #            #
#   #                #      #      #    #    #        #     #     #            #
#   #                #      #      #    #    #        #     #     #            #
#   #           #    #      #      #    #    #        #     #     #    #       #
#   #           #    ##     #      #    #    #        #     #     #    #       #
#   #                #      #      #         #        #           #    #       #
#    #######    #### #      #      #######   #                    #    #       #
#           #        #      #      #         #                    #    #       #
#           #        #      #      #         #         ##         #    #       #
#                    #      #      #         #              #     #    #       #
#   #                #      #                #        #     #     #    #       #
#   #   ####     ### #      #############    #        #     #     #    #       #
#   #                #      #    #    #      #        #     #     #    #       #
#   #       #        #      #    #    #      #        ####    ### #    #       #
#   #       #        #      #         #      #        #           #    #       #
#                           #         #      #        #           #    #       #
######################      #         #      #        #           #    #       #
#      #                    #         #               #           #    #       #
#      #                    #    #    #               #      #    #    #       #
#      #                    #    #    #               #      #    #    #       #
#      #                    #    #                    #      #    #    #       #
####   ##############    ## #    #           #        #      #    #    #       #
#      #           #        #    #           #        #      #         #       #
#      #           #        #    #####    ## #        #      #         #       #
#                  #        #    #           #        #      #         #   #####
#                  #        #    #           #        #      #         #       #
#                  #        #    #           #        #      #    #    #       #
#                           #    #           #        #      #    #    #       #
#                           #    #           #        #   ## #    #    #       #
#                                #           ######   #      #    #    #       #
################################    ######## #        #      #    ##    ########
#     #        #    #          #      #      #        #      #    #            #
#     #        #               #      #      #        #      #    #            #
#              #               #      #      #        #      #    #            #
#              #         #     #      #      #                                 #
#      ##      #         #     #      #      ############    ###################
###            #    #### #            #      #             #    #      #       #
#     #        #    #    #            ##     #             #    #      #       #
#     #        #    #    #            #      #             #    #      #       #
#     #        #    #    ###    ##### #      #             #    #      #       #
#              #    #    #      #     #      #             #    #      #       #
#   ###########     #    #      #     #      ####    ##### #    #      #       #
#                        #      #     #      #        #    #    #      #       #
#                        #      #     #      #             #    #      #       #
#                        #      #     #      #             #    #      #       #
#              #         ###    #     #      #             #    #      #       #
#              #    #    #      #     #      #   #####     #    #      #       #
#                   #    #      #     #      #        #    #    #      #       #
####################     #      #            #        #    #    #              #
#          #             #      ###          #        #         #              #
#          #             #      #            #        #         #              #
#          #             #      #            #                  #              #
#          #             #            #      ##    #############       ###    ##
########   ########      #            #      #    #       #            #       #
#                        #            #      #    #       #            #       #
#                        #            #      #    #       #            #       #
#                        #            #      #            #     #      #       #
#                        #            #      #                  #              #
#########################    ######## #      #                  ############   #
#             #                       #      #                  #     #        #
#             #                       #      #    #             #              #
#             #                       #      #    #             #              #
#                                     #      #    ##    ####### #              #
#                                     #      #    #             #   ## ######  #
#                                     #      #    #            *#     #        #
#                                     #      #    #             #     #        #
#             #                       #      #    #             #     #        #
################################################################################
