80 80
################################################################################
#     #               #       #           #     #                              #
#     #               #       #           #     #                              #
#     #    #          #       #                 #                       #      #
#     #    #          #                         #                       #      #
#     #    ########   #                         #                              #
#     #    #          #           ############# #########################    ###
#     #    #          #                                                        #
#     #    #          #       #                                                #
#     #               #       #                                                #
#     ##########      #       #                                                #
#     #         #     #       #######    #######################################
#     #         #     #       #      #     #      #                            #
#     #         #     #       #      #     #      #                            #
#     #         #     #       #      #     #      #                            #
#     #         #     #       #            #                                   #
#     #         #     #       #            #                                   #
#     #         #     #       #            #                                   #
#     #         #     #       ##########   #                                   #
#     #         #     #       #      #     #      #                            #
#     #         #     #    ## #            ########    #########################
#     #         #     #       #                                                #
#     #         #     #       #                                                #
#     #         #     #       #                                                #
#     #         #     #                                                        #
#     #         #     ######################    ################################
#     #         #     #                         #      #                       #
#               #     #                         #      #                       #
#               #     #                         #                              #
#               #     #                         #                              #
#               #     #############    ######## #                              #
#     ####      #     #        #     #    #     #                              #
#     #         #     #        #     #          #                              #
#     #         #     #        #     #          ####    ########################
#     #         #     #        #     #          #            #           #     #
#     #         #     #        #                #            #           #     #
#     #         #     #        #          #     #            #           #     #
#     #         #     #        #          #     #     #      #           #     #
#     #         #     #        #    ##### #     #  *  #      ###   #     #     #
#     #               #              #    #     #     #      #     #     #     #
#     #               #                   #     #     #      #     #     #     #
#     #               #                   #     #     #   ## #     #     #     #
#     #               #                   #     #     #      #     #     #     #
#     #         #     #        #          #     #     #      #           #     #
#     #         #     #        #     #          #     #      #    #######      #
#     #         #     #        #######    ##### #     #      #     #           #
#     #         #     #        #    #           #     #      #     #           #
#     #         #     #        #    #           #     #      #     #           #
#     #         #     #        #    #           ##    #      #     #     #     #
#     #         #     #        #    #           #     #      #     #     #     #
#     #         #     #        #    #           #     #      #    ##     #     #
#     #         #     #        #    #    #      #     #      #           #     #
#     #         #     #        #    #    #      #     #      #           #    ##
#     #         #     #        #    #    #      #     #      #           #     #
#     #         #     #        #    #    #      #     #      #           #     #
#     #         #     #        #    #    #      #     #      #     #     #     #
#     #         #     #        #    #    #      #     #      #     #     #     #
#     #         #     #        #    #    #      ###    ##### #     #     #     #
#     #         #     #        #    #    #            #            #     #     #
#     #         #     #        #    #    #            #            #           #
#     #         #              #         #                    #####    #########
#     #         #              #         #                                #    #
#     #         #      ####    #         #      #           ##            #    #
#     #         #              #         #      #            #            #    #
#     #         #     #        #    #    #      #     #      #            #    #
#     #         #     #        #    #    #   ## ##    #      #            #    #
#     #         #     #        #    #    #      #     #      #########    #    #
#     #         #     #        ###    ## #      #     #      #       #    #    #
#     #         #     #        #    #    #      #     #      #       #    #    #
#     #         #     #        #    #    #      #     #      #       #    #    #
#     #         #     #        #    #    #      #     #      #       #    #    #
#     #         #     #        #    #    #      #     #      #       #    #    #
#     #         #     #        #    #    #      #     #      #    ## #    #    #
#     #               #        #    #    #      #     #      #       #    #    #
####    ############# #        #         #      #     #      #       #         #
#                #    #        #         #      #     #      #                 #
#                #    #        #         #      #     #      #                 #
#                     #        #         #      #     #      #                 #
#                     #        #    #    #      #     #      #            #    #
################################################################################
