80 80
################################################################################
#        #                 #      #     #          #          #      #    #    #
#        #                 #      #     #          #          #      #    #    #
#        #                 #      #                                  #    #    #
#        #         ####### #   ## #                                  #         #
#   #    #    #     #      #      #                                  #         #
#   #    #    #     #             ####    ######### #############    #         #
#   #    #    #                   #                #          #      #         #
#   #    #    #                   #                #          #      #    #    #
#   #    #    #                   #                #                 #    #    #
#   #    #    ################    #        #       #                 #    #    #
#   #    #    #    #              #        #       #                 #    #    #
#   #         #                   #        #       #                      #    #
#   #         #                   #        #       #                      #    #
#             #                   #                                       #    #
######        #     ##########    #    ##############################     #    #
#        #    #    #              #          #      #                #    #    #
#        #    #    #              #          #      #                #    #    #
#        #    #    #              #          #                       #    ##   #
#        #    #    #              #          #                       #    #    #
#        #    #    #     #         ####      #                       #    #    #
#        #    #    #     #             #     #                       #    #    #
#######    ## #    #     #             #                             #    #    #
#      #      #    #     #                                           #    #    #
#      #      #    #     ######   #           ####################   #    #    #
#      #      #    #     #        #                   #              #    #    #
#      #      #    #     #        #          #        #              #    #    #
#      #      #    #     #        #    #     #        #              #    #    #
#      #      #    #     #        #    #     #        #              #    #    #
#      #      #    #     #        #    #     #                       #    #    #
#      #      #    #     #        #    #     #                       #    #    #
#      #      #                                                      #    #    #
#   ## #      #####################    ############################# #    #    #
#             #                                                      #    #    #
#             #                                                      #    #    #
#             #                                                      #    #    #
#                                                                    #    #    #
##########    ###################################################### #    #    #
#                                                         #    #     #    #    #
#                                                         #    #     #    #    #
#                                                         #    #     #    #    #
#                                                         #    #     #    #    #
#   ## ##########    #################################### #          #    #    #
#      #                                                  #          #    #    #
#      #                                                  #          #    #    #
#      #                                                  #          #    #    #
#      #                                                  #          #    #    #
#                                                         #   ###### #    #    #
#########    ############################################ #          #    #    #
#                                                         #          #    #    #
#                                                         #          #    #    #
#                                                         #          #    #    #
#                                                               #    #    #    #
####   ########################################    #######      #    #    #    #
#      #                                                        #    #    #    #
#      #                                                        #    #    #    #
#      #                                                  #     #    #    #    #
#      #                                                  #     #    #    #    #
#                                                                         #    #
#################################################################    #### #    #
#          #                                #                             #    #
#          #                                #                             #    #
#          #                                #                             #    #
#          #                                                      #       #    #
#    #                                                            #       #    #
#    #                                                            #       #    #
#    #      ######    ########################################### #####   #    #
#    #                                                            #       #    #
#####      #                                                      #       #    #
#    #     #                                                      #       #    #
#    #     #               *                                              #    #
#    #     #####################    ##################################### #    #
#    #     #                                 #                            #    #
#    #     #                                 #                            #    #
#    #     #                                 #                            #    #
#    #     #                                                              #    #
#          #                                                              #    #
#          #                                                              #    #
#          #                                                              #    #
################################################################################
