80 80
################################################################################
#    #                                                     #                   #
#    #                                                     #                   #
#    #            #                                        #                   #
#    #            #                                        #     #             #
#    #            #                                        #     #    #        #
#    #                                                     #     #    #        #
#    ###########################################    ###### #          ####    ##
#    #              #        #    #         #       #      #######    #        #
#    #                       #    #         #       #      #          #        #
#                            #    #         #                         #        #
#                                 #         #                         #        #
#                                 #    #    #####                     #        #
#                   #             #    #    #           ###           #        #
#    #              #             #    #    #       #      ###########    ######
#    #                       #    #         #       #      #     #       #     #
#    #    ################## #    #######   #       #      #     #       #     #
#    #                 #     #    #    #    #       #      #             #     #
#    #                 #     #    #          #######    ## #             #     #
#    #                 #     #    #                        #             #     #
#    #                 #     #    #                        #             #     #
#    #        #        #     #    #                        #     #       #     #
#    #        #              #    #    #    #      #       #     #       #     #
#    #        #              #    #    #    #      #       #     #       #     #
#    #                       #    #    #                   #     #       #     #
#    ############    ##      #    ##    ################## #     #       #     #
#    #                 #     #    #      #                 #     #       #     #
#    #                 #     #    #      #                 #     #       #     #
#    #                 #     #    #      #                 #     #       #     #
#    #                 #     #    #                        #     #       #     #
#    #        #        #     #                        #    #     ####    #     #
#    #        #        #     #                        #    #     #       #     #
#    #                       #     ###########    ### #    #     #       #     #
#    ######################    ###         #     #    #    ##    #       #     #
#    #       #             #      #        #     #    #    #     #       #     #
#    #       #             #      #        #     #    #    #     #       #     #
#    #       #             #      #        #     #    # *  #     #       #     #
#    #                     #      #####    #     #    #    #     #       #     #
#    #                #    #      #        #     #    #    #     #       #     #
#    #                #    #      #        #     #    #    #     #       #     #
#    #                #     ###   #        #   ##     #    #     #       #     #
#    ##############   #           #                   #    #     #       #     #
#    #       #        #           #                   #    #             #     #
#    #       #        #           #                   #    #    ######## #     #
#    #       #        #    #      #              #    #    #       #     #     #
#    #       #        #    #      #              #    #    #             #     #
#    #       ####     #    #      #              #    #    #             #     #
#    #       #        #    #      ##########     #    #    #             #     #
#    #    ###         #           #       #      #    #    #             #     #
#    #                ######      #       #      #    #    #       #     #     #
#    #                #           #              #    #    #       #     #     #
#    #                #           #              #    #    #       #     #     #
#    #                #           #              #    #    #       #           #
#                                 #                        #       #           #
##################################    #################### #       #           #
#                                                 #        #       #          ##
#                                                 #        #       #     #     #
#                                                          #       #     #     #
#                                                          #       #     #     #
#       #                                                  #       #     #     #
##      #                                                  #       #     #     #
#       #                                                  #       #     #     #
#       ####################    ########################## #       #     #     #
#       #    #                             #               #       #     #     #
#       #    #                             #               #       #     #     #
#       #    #                             #               #       #     #     #
#       #                          #       #               #       #     #     #
#       #                          #       #               #       #     #     #
#       #                          #                       #       #     #     #
#       #                          #                       #       #     #     #
#       #                          #                       #       #     #     #
#       #                          #####    ############## #       #     #     #
#       ##################    #### #    #                  #       #     #     #
#       #               #          #    #                  #       #     #     #
#       #               #          #    #                  ##      #     #     #
#       #               #          #    #                  #       #     #     #
#       #                          #                       #       #     #     #
#       #                          #                       #       #     #     #
#       #                          #                       #       #     #     #
################################################################################
