80 80
################################################################################
#             #    #           #      #    #    #     #           #            #
#             #    #           #           #    #     #           #            #
#             #    #           #           #    #     #     #     #            #
#    #        #    ###    #### #           #    #     #     #     #       ###  #
#    #        #    #      #    #           #    #     #     #     ####    #    #
#    #        #           #    #####    ## #    #     #     ###   #       #    #
#    #        #           #    #      #    #    #     #     #     #       #    #
#    #        #           #    #      #    #    #     #     #     #       #    #
#    #        #                #      #    #    #     #     #     #       #    #
#    #        #    #           #      #    #    #     #     #     #            #
#    #        #    #           #      #         #     #     #     ###    #######
#    #        #                #      #         #     #     #     #       #    #
#    #        ##############   #   ## #         #     #           #            #
#    #        #    #      #    #      #               #   ####### #            #
#    #        #    #      #    #           #          #      #                 #
#    #        #    #      #                #          #                        #
#    #        #    #      #                           #                   ##   #
#    #        #    #      #     ######    ##### #     #                   #    #
#    #        #    #      #                     #     #           #       #    #
#    #        #    #      #    #                #     #      #    #       #    #
#    #        #           #    #                #     #      #    #       #    #
#    #                    #    #                #     #                        #
#    #                    #    #                #     ################    ######
#    #                    #    #################      #           #    #       #
#    #             #      #    #    #          #      #           #    #       #
#    #        #    #      #    #               #      #           #    #       #
#    #        #    #      #    #               #      #           #    #       #
#    ###      #    #           #               #      #     #     #    #       #
#    #        #    #           #         #     #      #     #          #       #
#    #        #    #           #    #    #            #     #          #       #
#    #        #    #           #    #    #            #     #          #       #
#    #        #    #      #    #####     #   ##       #     #          #       #
#    #        #    #      #    #    #    #            #     #     #    #       #
#    #        #    #      #    #    #    #     #      #     #     #    #       #
#    #        #    #      #    #    #    #     #      #     #     #    #       #
#    #        #    #      #    #    #    #            #     #     #    #       #
#             #    #      #    #    #    ##########   #           #    #       #
######    ### #    #      #    #    #    #            #########   #    #       #
#    #        #    ####    ### #         #            #      #    #            #
#             #    #           #         #            #      #    #            #
#             #    #           #         #     #      #      #    #        #####
#             #    #           #         #     #      #      #    #            #
#     #####   #                                       #      #    #    #       #
#    #        #######    ############################ #      #    #    #       #
#    #        #                                       #      #    #    #       #
#    #        #                                       #      #    #    #       #
#    #        #                                       #      #    #    #       #
#    #        #                                       #      #    #            #
#    #        ############    ##########    ######### #      #    #    #########
#    #        #               #                       #      #    #            #
#    #        #               #                       #      #    #            #
#    #        #               #                       #      #    #            #
#                             #                       #      #    #        #   #
############################    ##################### #      #    #        #   #
#   #             #                      #     #      #      #    #        #   #
#   #             #                      #            #      #    #        #   #
#   #             #                      #            #      #    #        #   #
#   #        #    #                      #            #      #    #        #   #
#   #        #     #########    #########             #      #    #        #   #
#   #                          #    #                 #      #    #        #   #
#   ##    ########             #    #                 #      #    #        #   #
#   #                          #    #        ######## #      #    #        #   #
#   #             #    #       #         #       #    #      #    #        #   #
#   #             #    #       #         #       #    #      #    #        #   #
#                 #            #         #       #    #      #    #####    #   #
#         #       ########    ######     #       #    #      #    #        #   #
#         #       #                 #    ##      #           #    #        #   #
#         #       #                 #    #       #           #    #        #   #
#   #     #   ### #                      #                   #    #        #   #
#   #     #       #                      #                   #    #        #   #
#   #     #       #                                   #      #    #        #   #
#   #     #       ###############################     #      #    #        #   #
#   #     #       #                           #       #      #    #        #   #
#                 #                           #       #      #    #        #   #
###########    ## #                           #       #           #        #   #
#                 #                                   #           #        #   #
#                 #                       *           #           #        #   #
#                 #                                   #           #        #   #
################################################################################
