80 80
################################################################################
#   #     #         #    #        #             #     #         #        #     #
#   #                    #                      #     #         #        #     #
#   #                    #                      #               #        #     #
#   #      ####          #                      #               #        #     #
#                        #                      #               #        #     #
#         #         #    #######    ########### #               #        #     #
#         #         #    #           #          #     #         #        #     #
#         #         #    #           #          #     #         #        #     #
#   #     #              #                      #     #         #        #     #
#   #     #####    ##### #     #                #     #         #        #     #
#   #     #        #     #     #          #     #     #         #        #     #
#   #     #        #     ##    #          #     #     #         #              #
#   #     #        #     #     #     #    #     #     #         #              #
##    ### #              #     #######    #     #     #         #              #
#         #              #     #          #           #                        #
#         ###    ##      #     #          #           #                  #     #
#         #              #     #          #           #####              #     #
#   #     #        #     #                #           #              ### #     #
#   #     #        #     ##########    ## #     #     #         #        #     #
#                        #         #      #     #     #         #        #     #
##############    ###### #         #      #     #     #         #        #     #
#       #    #      #    #                #     #     #         #        #     #
#       #    #      #    #                #     #     #         #        #     #
#       #    #      #    #                #           #         #        #     #
#       #           #    #################    ####### #         #        #     #
#       #           #    #                            #         #        #     #
#       #           #    #                            #         #              #
#       #           #    #                            #         ##    ##########
#       #    #      #    #                                      #          #   #
#       #    #      #    ###############    ################### #          #   #
#       #    #      #    #             #       #                #          #   #
#       #    ##     #    #             #                        #     #    #   #
#       #    #      #    #             #                        #     #    #   #
#       #    #      #    #             #                        #     #    #   #
#       #    #           ###########   #                        #     #    #   #
#       #    #           #       #     #                        ######     #   #
#       #    #           #       #     ########    ############ #          #   #
#       #    #           #       #     #                        #              #
#       #    #           #             #                        #              #
#       #    #           #                                      #              #
#   ### #    #   ####### #                           #          #     #        #
#       #    #     #     #                           #          #     #        #
#       #    #     #     #       #                                             #
#       #    #           ####    ###############################################
#       #    #           #      #    #       #     #               #     #     #
#       #    #           #      #            #                     #     #     #
#       #    #           #      #            #                     #           #
#       #    #     #     #      #            #           #         #           #
#       #    #     #     #      #            #           #         #           #
#       #    #     #     #      #    #       #######     #         #           #
#       #    #     #     #      #    #       #      #    #         #     #     #
#       #    #     #     #           #       #      #    #         #     #     #
#            #     #     #           #       #      #    #         #     #     #
#            #     #     #           #       #      #    #         #     #     #
#            #     #     #           #       #      #    #         #     #     #
#            #     #     ###    #    #   ### #      #    #         #     #     #
#       #    #     #     #      #    #       #      #    #         #     #     #
#       #    #     #     #      #    #       #      #    #         #           #
#       #    #     #     #      #    #       #      #    #         ##########  #
#       #    #     #     #      #    #       #      #    #   ######        #   #
#       #    #     #     #      #    #       #      #    #                     #
#       #    #     #     #      #    #       ####   #    #                     #
#       #    #     #     #      #    #       #      #    #                     #
#       #    #     #     #      #    #       #      #    #                     #
########     #     #     #           #       #      #    #                     #
#            #     #          ###### #                   ##################    #
#            #     #           #     #                   #      #              #
#            #     #           #     #                   #      #              #
#            #     #                 #                   #                     #
#   #        #     #     #           #       #           #                     #
#   #        #     #     #                   #                                 #
#   #        #     #     #######    ######## ######################    #########
#   #        #     #     #                   #       #                         #
#   #    ### #     #     #                   #       #                         #
#   #        ###   #     #                   #       #                         #
#   #        #     #     #     #           * #       #                         #
#   #        #     #     #     #             #                                 #
#   #        #     #     #     #             #                                 #
################################################################################
