80 80
################################################################################
#          #        #         #        #              #      #        #    #   #
#          #        #         #        #              #      #        #    #   #
#          #        #         #        #              #      #        #    #   #
#####      #        #                                 #      #        #    #   #
#   #      #        #                           #     #      #        #    #   #
#   #               #                   ####    ######       #        #    #   #
#   #               ################            #            #        #    #   #
#   #       ###                        #        #            #        #        #
#   #                                  #                     #        #        #
#          #                           #                     #        #        #
#          #                  #        #                     #        #        #
#                   ##    ### ####     ###########    ###### #        #    #   #
#################   #         #        #                     #        #    #   #
#   #               #         #        #                     #        #    #   #
#   #               #         #        #                     #        #    #   #
#                   #                                        #        #    #   #
#                   ##    ################################## #        #    #   #
#                   #                                        #        #    #   #
#                   #                                        #        #    #   #
#                   #                                        #        #    #   #
#                                                            #        #    #   #
#############################    ########################### #        #    #   #
#     #         #     #    #     #     #      #    #         #        #    #   #
#     #         #     #    #     #     #      #    #         #        #    #   #
#               #     #    #     #     #      #    #         #        #    #   #
#               #     #    #     #     #      #              #        #    #   #
#               #          #     #     #      #              #        #    #   #
####    ####### #          #     #     #      #              #        #    #   #
#      #                         #     #      ##    ######## #        #    #   #
#      #                         #     #      #       #      #        #    #   #
#      #         ###    ###      #     #      #              #        #    #   #
#      #                         #     #      #              #        #    #   #
#      #        #          #     #     #      #                       #    #   #
#               #          #     #     #                              #    #   #
#               #          #     #     #              #               #    #   #
#               #          #     ###   ###            #               #    #   #
#############    ######### #     #     #              #      #        #    #   #
#    #     #          #    #     #     #      #       #      #        #    #   #
#    #     #          #    #     #     #      #       #      #        #    #   #
#    #                #    #     #     #      #       #      #####         #   #
#    #                #    #           #      #       #      #             #   #
#    #                #    #           #      #       #      #             #   #
#    #                #    #                  #       #      #             #   #
#    #                #    #                  #       #      #        #    #   #
#    #                #    #     #            #       #      #        #    #   #
#    ###########    ##     #     #            #       #      #        #    #   #
#    #                     #     #     #      #       #      #        ###    ###
#    #                     #     #     #      #       #      #        #   *#   #
#    #                     #     #     #      #       #      #        #    #   #
#    #                     #     #     #      #       ##     #        #    #   #
#    #                     #     #            ##      #      #        #    #   #
#    ###################   #     ##    ###### #       #      #        #    #   #
#    #     #    #          #     #            #       #      #        #    #   #
#    #     #               #     #            #       #      #        #    #   #
#    #                     #     #            #       #      #        #    #   #
#                          #     #            #       #      #        #    #   #
#                          #     #     #      #       #      #        #    #   #
#              ########### #     #     #      #       #      #        #    #   #
#          #       #       #     #                           #        #    #   #
#    #     #       #       #     #################    ###### #        #    #   #
#    #     #       #       #     #        #           #      #        #    #   #
#    #     #       #       #     #        #                  #        #    #   #
#    #     #       #       #     #        #                  #        #        #
#    #     #       #       #     #        #                  #        #        #
#    #     #       ###     #     #        #                  #        #        #
#    #     #       #       #     #   #### #                  #        #        #
#    #     #       #       #     #        ############    ## #        #    #   #
#    #     #               #     #               #           #        #    #   #
#    #     #               #     #               #           #        #    #   #
#    #     #               #     #                           #        #    #   #
#    #     #               #     #                           #        #    #   #
#    #     #       #       #     #                           #        #    #   #
#    #     #       #       #                                 #        #    #   #
#    #     ##      #       ######################    ####### #             #   #
#    #     #       #       #                                 ##############    #
#    #     #       #       #                                 #                 #
#    #     #       #       #                                 #                 #
#    #     #       #       #                                 #                 #
################################################################################
