80 80
################################################################################
#   #     #        #    #    #                              #    #     #       #
#   #     #        #    #    #                              #    #     #       #
#   #     #        #         #                              #    #     #       #
#         #        #         #########    ################# #    #     #       #
#         #        #         #     #                        #    #     #       #
#         #        #               #                        #          #       #
#         #        #                                        #          #       #
#    #### #        #   ######               #               #          #       #
#         #        #                        ############    #          #       #
#         ####     #         ##########     #               #    #     #       #
#                  #         #     #        #               #    #     #       #
#                  #    #    #     #        #               #    #     #       #
#                  #    #    #     #        #               #    #     #       #
#   #              #    #    #              #          #    #    #             #
#   ############## #    #    #              #          #    #    #             #
#   #    #    #    #    #    #              #          #    #    #             #
#   #    #    #    #                                        #                ###
#        #    #    ############    ######################## ######    ##       #
#             #    #        #           #                   #     #    #       #
#             #    #        #           #                   #     #    #       #
#             #    #        #           #                   #     #    #       #
#   #         #    #        #           #                   #     #    #       #
#   #######   #    #        #   ####### ############    ### ###   #    #       #
#   #    #    #    #        #     #     #                   #     #    #       #
#   #    #    #    #        #                               #     #    #       #
#   #    #    #    #                                        #          #       #
#   #    #    #    #                                        #          #       #
#   #    #    #    #                                        #          #       #
#   #    #    #    #         ########    ################## ###########    #####
#   #    #    #    #        #                                    #             #
#   #    #    #    #   #### #                                    #             #
#   #    #    #    #        #                                                  #
#   #    #    #    #        #                          #                       #
#   #    #    #    #        #                          #    #                  #
#   #         #    #        #                          #    #                  #
#   #              #                                                           #
#   #              ###############################    ##########################
#   #              #          #                          #     #          #    #
#   #              #          #                          #     #               #
#   #         #    #          #                          #     #               #
##    ####### #    #          #           #              #     #               #
#       #     #    #    #     #           #              #     #               #
#       #     #    #    #     #           #                    #          #    #
#       #     #     ####      #           #                    #          #    #
#       #     #         #     ##########    #############      #               #
#       #     #         #     #                                ####    #########
#       #     #         #     #                          #     #           #   #
#       #     #    #    #                                #     #           #   #
#       #     #    #    #                                      #           #   #
#       #     #    #    #      ###########################     #      #    #   #
#       #     #    #    #                         #            ###    #        #
#       #     #    #    #     #                                #      #        #
#    ## #     #    #    #     #                                #      #        #
#       #     #    #    #     #                                #      #        #
#       #     #    #    #     #                        ####### #      #    #   #
#       #     #    #    #     #    ############## #      #                 #   #
#       #     #    #    #     #         #         #      #           ##### #   #
#       #     #    #    #     #         #         #                  #     #   #
#       #     #    #    #     #                   #                  #     #   #
#       #     #    #    #     #                   #            #           #   #
#       #     #    #    #     #                   #            #           #   #
#       #     #    #    #     #                   #            #           #   #
#       #     #    #    #     #                                                #
#       #     #    #    ##    ################    ##############################
#       #     #    #    #     #              #                                 #
#       #     #    #    #     #              #                                 #
#       #     #    #    #     #              #                                 #
#       #     #    #    #     #              #                                 #
#       #     #    #    #     ###########    #####################    ##########
#       #     #    #    #     #     #        #           #                     #
#       #     #    #    #     #     #        #           #                     #
#       #     #    #    #     #              #         * #                     #
#       ##    #    #    #     #              #           #                     #
#       #     #    #    #     #           ## #########   #                     #
#       #     #    #    #     ##                  #      #############    ######
#             #    #    #     #     #                                          #
#             #    #          #     #                                          #
#             #    #          #     #                                          #
################################################################################
