80 80
################################################################################
#         #                                      #    #         #    #     #   #
#                                                #    #              #     #   #
#              #                                 #    #              #     #   #
#              #                                 #    #              #     #   #
#####    ##### #                                 #    #              #     #   #
#         #    ####################    ######### #    #         #    #     #   #
#         #    #                                 #    #         #    #     #   #
#         #    #                                 #    #         #    #     #   #
#         #    #                                 #    #         #    #         #
#              #                                 #    #         #    #         #
#              #       #                         #    #         #    #         #
#              #       #                         #    #         #    #         #
#                                                #    #    #### #    #     #   #
#############################################                   #    #     #   #
#                                    #    #                     #    #     #   #
#                                    #    #                     #    #     #   #
#                                    #    #                     #    #     #   #
#                   #                #    #      #    #         #    #     #   #
#                   #                #           #    #         #    #     #   #
#                   #                            #    #         #    #     #   #
#                   #                            #    #         #    #     #   #
#################    ################            #    #         #    #     #   #
#        #                                ###### #    #         #    #         #
#        #                           #           #    #         #    #   #######
#        #                           #           #    #         #    #     #   #
#                                    #           #    #         #    #     #   #
#                                    #    #      #    #         #    #     #   #
#                                    #    #      #    #         #    #     #   #
#                                                #    #              #     #   #
###############################################    ## ##    ######## #     #   #
#                                  #          #       #      #       #     #   #
#                                             #       #      #       #     #   #
#                                             #       #      #       #     #   #
#                                             #       #      #       #     #   #
#                                             #       #      #       #     #   #
#######################    ################## #       #      #       #     #   #
#        #      #          #                  #       #                    #   #
#        #      #          #                  #       #                    #   #
#        #      #          #                  #       #          ####      #   #
#        #      #          #          #       #       #                    #   #
#    ### #      #     #    #          #       #       #      #       #     #   #
#   #    #      #     #    #                  #       #      #       #     #   #
#   #    #      #     #    ################   #       #      #   *   #     #   #
#   #    #      #     #    #                  #       #      #       #     #   #
#   #    #      #     #    #                  #       #      #       #     #   #
#   #    #      #     #    #                  #       #      #       #     #   #
#   #    #      #     #    #                  #       #      #       #     #   #
#   #    #      #     #    #             #    #       #      #       #     #   #
#   #    #      #     #    ######    ### #    #       ####   #       #     #   #
#   #    #      #     #    #     #       #    #       #      #       #     #   #
#   #    #      #     #    #     #       #    ####    #      #       #     #   #
#   #    #      #     #    #             #    #       #      #       #     #   #
#   #    #      #     #    #             #    #       #      #       #     #   #
#   #    #      ##    #        ##        #    #       #      #       #     #   #
#   #    #      #     #                  #    #       #      #       #     #   #
#   #           #     #          #       #    #       #      #       #     #   #
#   #           #     #          #       #    #       #      #       #     #   #
#   #           #     #    #     #       #    #       #      #       #     #   #
#   #           #          #     #       #    #       #      #       #         #
#   #    #      ##    #### #     #    ## #    #       #      #       #         #
#   #    #      #          #     #       #    #       #      #       #         #
#   #    #      #          #     #       #    #       #      #                 #
#        #      #          #     #       #    #       ####    ##################
#        #      #                                     #          #       #     #
#        #      #   ##########################        #          #       #     #
#        #      #                       #             #          #       #     #
#        #      #                                     #          #             #
#########    ## #                             #       #                        #
#          #    #                             #       #                        #
#          #    ############    ########      #       #                        #
#               #    #                  #     #       #                  #     #
#               #    #                  #     #       #                  ###   #
#     #              #                  ##    #       #############      #     #
#  ## #              #                  #     #       #                  #     #
#     ###    ###         ############## #     #       #                  #     #
#     #                                 #     #       #                  #     #
#     #         #                       #     #       #                  #     #
#     #         #                       #     #       #            #     #     #
################################################################################
