80 80
################################################################################
#     #     #        #                                               #    #    #
#     #     #        #                                               #    #    #
#     #     #        #                                               #    #    #
#     #     #        ###########################    ################ #    #    #
#     #     #    ####                                   #            #    #    #
#     #     #                                                        #         #
#     #     #                                                        #         #
#     #     #                                  #                     #         #
#           #        ########    ############# #                     #        ##
#           #        #                         #####    ############ #    #    #
#           #        #                         #                     #    #    #
#           #        #                         #                     #    #    #
#     #     #        #                         #                     #    #    #
#     #     #                                                        #    #    #
#     #     ###########################    ######################### #    #    #
#     #     #                    #                              #         #    #
#     #     #                    #                              #              #
#     #     #                                                   #     #######  #
#     #     #                                                                  #
#     #     #                                                        #         #
#           #                                                        #         #
##    ##### #                                                        #    #    #
#    #      #                                                   #    #    #    #
#    #      #    ############################################## #    #    #   ##
#    #      #                                                   #    #    #    #
#    #      #                                                   #    #    #    #
#    #      #                                                   #    #    #    #
#    #      #                                                   #              #
#    #      ##################################################    ##############
#    #      #     #     #      #      #                  #              #      #
#    #      #     #     #      #      #                  #              #      #
#    #      #     #     #      #      #                  #              #      #
#    #      #     #     #             #         *        #       #      #      #
#    #      #     #     #             #                          #      #      #
#    #      ##    #     #             #                          #             #
#    #      #     ###                 #                          #             #
#    #      #                  #      #                          #             #
#    #      #            ##    ###    #######    ############### #           ###
#    #      #                  #      #        #     #      #    #      #      #
#    #      #           #      #      #        #     #           #      #      #
#    #      #     #     #      #      #        #     #           #      #      #
#    #      #     #     #      #      #        #     #           #      #      #
#    #      #     #     #      #      #####    #     #           #      #      #
#    #      #     #     ####    ##### #              #      #    #      #      #
#    #      #           #       #     #              #      #    #      #      #
#    #      #########   #       #     #         ##   #      #    #      #      #
#    #      #     #     #       #     #              #      #    #             #
#    #      #     #     #       #     #        #     #      #    ###    ########
#    #            #     #    ## #     #        #     ##     #    #      #      #
#    #            #     #       #     #              #      #    #      #      #
#    #          ##      #       #     ############   #      #    #      #      #
#    #                  #             #     #        #      #    #             #
#    #      #           #             #     #        #      #    #             #
#    #      #           #             #     #        #      #    #             #
#    #      #     #     #             #     #         ####    ## #             #
#    #      #     #     #       #     #     #                    #      #      #
#    #      #     #     #       #     #     #                    #      #####  #
#    #      #     #     #       #     #     #                    #      #      #
#    #      #     #     #       #     #     #        #           #      #      #
#    #      #     #     #       #           #        #    #   ## #      #      #
#    #      #                               #        #    #      #      #      #
#    #      ################    ######      ##    ## #    #      #      #      #
##   #      #                 #             #        #    #      #      #      #
#    #      #                 #       #              #    #      #      #      #
#    #      #                 #       #              #    #      #      #      #
#    #      #                 #       #                          #             #
#    #      #                 #       ###########################    ###########
#    #      #                 #       #            #                   #       #
#    #      ####    ######### #   ### #            #                   #       #
#    #      #      #     #            #            #                   #       #
#    #      #      #                  #            #                           #
#    #      #                         #   ######## #                           #
#    #      #                         #      #     #                           #
#    #      ###               #       #      #     #####    ####################
#    #      #           ##### #       #            #                      #    #
#           #      #          #       #            #                      #    #
#           #      #          #       #                                        #
#           #      #          #       #                                        #
################################################################################
