80 80
################################################################################
#                         #    #    #                   #     #            #   #
#                         #    #    #                   #     #            #   #
#                         #    #    #                   #     #            #   #
#                         #    #    #                   #     #                #
#                         #    #    #                         #                #
##################    ### #         #                         #                #
#   #    #       #        #         #                         #                #
#   #    #       #        #         ##########    ########### ####    ##########
#   #            #                  #       #      #     #    #      #     #   #
#                #             #    #                         #      #     #   #
#                #             #    #                         #      #     #   #
#                #             #    #                         #      #     #   #
#        #       #        #    #    #                         #      #     #   #
#        ##      #        #    #    #       ####   #     #    #      #     #   #
######   #       #        #    #    #       #      #     #    #      #     #   #
#        #       #        #    #    #    ## #      #     #    #      #     #   #
#        #       #        #    #    #       #      ###    ### #      #     #   #
#        #       #        #    #    #       #      #     #    #      #     #   #
#                #        #    #    #       #      #     #    #      #     #   #
#   #############         #         #       #      #     #    #      #     #   #
#        #                #   ##### ######    #### #     #    #      #     #   #
#        #                #         #              #     #    #      #     #   #
#        #                #                        #          #      #     #   #
#        #       #        #                        #          #      #     #   #
#        #       #        #                        #          #      #     #   #
######   #       #####    ######################    ######### ####   #         #
#        #       #        #                                   #      #         #
#        ####    #        #                                   #      #         #
#        #       #        #                                   #      #         #
#        #       #        #                                   #      #     #   #
#   #    #       #        #####    #################### ##    #      #     #   #
#   #    #       #        #                             #     #      ####    ###
#   #            #        #                             #     #      #     #   #
#   #            #        #                             #     #      #     #   #
#                                                             #      #     #   #
#  ########################################################## #      #     #   #
#                     #      #        #        #              #      #     #   #
#                     #               #        #              #      #     #   #
#                     #               #        #              #      #     #   #
#                     #               #        #              #      #     #   #
#                     #               #####    ######    #### #      #     #   #
#####    ############ #      #        #             #         #      #     #   #
#    #    #     #     #      #        #             #         #      #     #   #
#    #    #     #     #               #             #         #      #     #   #
#    #    #     #     #   ############                        #      #     #   #
#    #    #     #     #                                       #      #     #   #
#    #    #     #     #                                       #            #   #
#    #    #     #     #                     ################# #            #   #
#         #     #     #               #                       #            #   #
#         #     #     #        #      #                       #            #   #
#         #     #     #        #      #                       #      #     #   #
#         #     #     #        #      #     #                 #      #     #   #
#    #    #     #     #                     #                 #      #     #   #
#    #### #     #     #####################    ############## #      #     #   #
#   #     #     #     #            #                     #    #      #     #   #
#   #     #     #     #            #                     #    #      #     #   #
#   #     #     #     #            #                     #    #      #     #   #
#   #     ###   #     #            #                     #    #      #     #   #
#   #     #     #     ###    ##### #                     #    #      #     #   #
#   #     #     #     #     #      #        #    *       #    #      #     #   #
#   #     #     #     #     #      #        #            #    #      #     #   #
#   #     #     #     #     #      #                     #    #      #     #   #
#   #     #     #     #     #      ###    ############## #    #      #     #   #
#   #     #     ##    ##    #      #                     #    #      #     #   #
#   #     #           #     #                            #    #      #     #   #
#   #     #           #     #                            #    #      #     #   #
#   #     #           #     #                            #    #      #     #   #
#   #     #           #     ####                    #         #      #     #   #
#   #     ##    ##### #     #      ####    ######## #         #      #     #   #
#   ###   #           #     #      #                #         #      #     #   #
#   #     #                        #                #         #      #     #   #
#   #     #                        #                #    #    #      #     #   #
#   #     #                                              #    #      #     #   #
#   #     #    ###     ################    ############# #    #      #     #   #
#   #     #    #      #              #                   #           #         #
#              #      #              #                   #           #         #
#              #      #                                  #           #         #
#              #      #                                  #           #         #
################################################################################
