80 80
################################################################################
#   #     #       #                       #                                    #
#   #     #       #                       #                                    #
#   #     #       #         #             #                                    #
#   #     #       #    #### #    #                                             #
#   #             #    #    #    #                                             #
#   #             #    #    #              ###################    ##############
#   #             #    #    ########    ##           #                         #
#   #             #         #             #                                    #
#   #     #       #         #             #                                    #
#   #     #       #         #             #                                    #
#   #     #       #         #             #           ###    ###################
#   ##    #       #         #             #          #     #                   #
#   #     #       ########    ########### ########   #     #                   #
#   #     #    ## #         #             #          #                         #
#   #     #       #         #             #          #                         #
#   #     #       #                       #          #                         #
#   #     #       #                       #          #                         #
#   #     #       #                                                            #
#   #             ####################################    ######################
#   ##    ####### #          #          #    #                        #    #   #
#   #     #       #          #          #    #                        #    #   #
#   #     #       #          #          #    #                        #    #   #
#   #             #          #          #    #                  #     #    #   #
#   #             ##    ##### #####     #     ###    ########## ##    #    #   #
#   #      ###    #               #     #                #      #     #    #   #
#   #             #               #     #                       #     #    #   #
#   #     #       #                     #                       #     #    #   #
#   #     #       #                     #    #                  #     #    #   #
#   #     #       #                     #    #                        #    #   #
#   #     #       ######    ########### #    ######################   #    #   #
#         #       #     #          #    #    #     #            #     #    #   #
#         #       #     #          #    #    #     #            #     #    #   #
#         #       #     #          #    #    #                  #     #    #   #
#         #       #     #          #    #    #                  #     #    #   #
#   #     #       ###   ########   #    #    #                        #    #   #
#   #     #       #                #    #    #                        #    #   #
#   #     #       #                #         #######    ########      #        #
#   #     #       #                #         #     #                  #        #
#   #     #                        #         #                  #     #        #
#   #     #        ##########      #         #                  #     #        #
#   #     #                 #      #    #    #                  #     #    #   #
#   #     #                        #    #                             #    #   #
#   #     #       #                #    #########    ################ #    #   #
#   #     #       #                #    #     #    #         #        #    #   #
#   #     #       #    #           #    #     #    #         #        #        #
#   #     #       #    ##    ##### #    #     #    #         #        #   ######
#   #     #       #    #     #     #    #     #    #         #        #    #   #
#   #     #       #    #           #    #     #              #        #    #   #
#   #     #       #    #           #    #     #              #        #    #   #
#   #     #       #    #           #    #     #              #        #        #
#   #     #       #    #           #    #     #              #        #        #
#   #     #       #    #     #     #    #     #######    ### ##    ## #        #
#   #     #       #    #     #     #    #     #              #        #        #
#   #     #       #    #     #          #     #              #        #    #   #
#   #     #       #    #     #          #     #                       #    #   #
#   #     #       #    #     #          #     #                       #    #   #
#   #     #       #    #     #          #     #                       #    #   #
#   #     #       #    #     #     #    #   ## ######    ############ #    #   #
#                 #    #     #     #    #                 #      #    #    #   #
#   ############# #    #     #     #    #                 #           #    #   #
#     #    #      #    #     #     #    #                             #    #   #
#     #    #      #    #     #     #    #     #                       #    #   #
#     #    #      #    #     ###   #    #     #                       #    #   #
#     #    #      #    #     #     #    #     ##    ############ #    #    #   #
##    #    #      #    #     #     #    #     #             #    #    #    #   #
#     #    #      #    #     #     #    #     #             #    #    #    #   #
#     #    #      #    #     #     #    #     #             #    #    #    #   #
#     #    #      #    ###   #     #    #     #             #    #    #    #   #
#     #    #      #    #     #     #    #     #########    ##    #    #    #   #
#     #    #      #    #     #     #    #     #                  #    #    #   #
#     #    #      #    #     #     #    #     #                  #         #   #
#                 #    #     #     #    #     #                  #         #   #
#                 #    #     #     #    #                                      #
#                 #    #     #     #    #######    #############################
#  ########       #    #     #     #    #                              #       #
#          #      #    #     #     #    #                                      #
#          #      #    #     #     #    #                                      #
#          #      #    #     #*    #    #                                      #
################################################################################
