80 80
################################################################################
#                     #          #              #                              #
#                     #          #                                             #
#                     #    #     #                                             #
############    ##### #    #     #                                             #
#   #     #     #     ###    ### #                                             #
#         #     #     #    #     #                                             #
#         #           #    #     ##########    #################################
#         #           #          #       #        #     #    #      #    #     #
#         #           #          #       #        #     #    #      #    #     #
#  ###### #                      #       #        #     #    #      #          #
#    #    ####    ####           #       #        #     #    #      #          #
#    #    #      #         #     #       ######   #     #    #      #          #
#    #           #         #     #       #        #     #    #      #          #
#    #           #    #    #     #       #        #     #    #      #    #     #
#    #           #    #    #     #       #        #     #    #      #    #     #
#    #           #    #    ##    #       #        #     #    #      #    #     #
#    #    #      #    #    #     #       #        #     #    #      #    #     #
#    #    #      #    #    #     #       #        #     #    #      #    #     #
##   #    #      #    #    #     #       #        #     #    #      #    #     #
#    #    #      #    #    #     #       #        #     #    #      #    #     #
#         #      #    #    #     #       #        #     #    #      #    ####  #
#         ####        #    #     #       #        #     #    #      #    #     #
#         #           #    #     #       #        #     #    #      #    #     #
#         #           #    #     #       #        #     #    #      #    #     #
#         #           #    #     #       #        ###   #    #      #    #     #
#         #                      #       #        #     #    #      #    #     #
##########    ################## #       #        #     #    #           #     #
#      #     #     #    #        #       #              #    #           #     #
#      #     #     #    #        #       #              #    #           #     #
#      #     #     #    #        #       #              #    #           #     #
#            #     #    #                #              #           ###    #####
#            #     #    #                #        #     #           #     #    #
#   ###      #     #    #                #        #     #           #     #    #
#            #     #    #                #        #     #           #     #    #
#      #     #     #    #        #                #     #    #      #     #    #
#      #     #     #    #        #                #     #    #      #     #    #
#      #     #     #    #        #                #     #    #      #     #    #
#            #     #    #        #                #     #####    ## #     #    #
##    ###### #     #    #        #       #        #     #      #    #     #    #
#      #     #     #    #        #       #        #     #      #    #     #    #
#      #     #     #    #        #       #        #     #      #    #     ##   #
#      #     #     #    #        #       #        #     #      #    #     #    #
#      #     #     #             #       #        #     #      #    #     #    #
#      #     #     #             #       #        #     #           #     #    #
#      #     #     #     ##      #       #        #     #           #     #    #
#      #     #     #             #       #              #           #     #    #
#      #     #     #    #        #      *##    ######## ####        #     #    #
#      #     #     #    #        ####    #              #      #    #          #
#      #     ##    #    #        #       #              #      #    #          #
#      #     #     #    #        #       #              #      #    #          #
#      #     #          #        #       #              #                      #
#      #     #          #        #       ##    ##       ########    ############
#      #     #          #        #       #      #       #         #       #    #
#            #          #        #       #      ####    #         #       #    #
#            #          #        #       #      #       #         #       #    #
#            #          #        #       #      #       #         #       #    #
#            #    ##### #        #       #      #       #    #    #            #
#      #     #    #     #        #                      #    #                 #
#      #     #          #        ####    ############## #    #                 #
#      #     #          #        #         #      #     #####      ###         #
#      #     #          #        #         #      #     #                 #    #
#      #     #                   #         #      #     #         #       #    #
#      #     #    ############## #         #      #     #         #       #    #
#      #     #    #              #         #      ###   #                 #    #
#      #     #    #              #         #      #     ###########    ## #    #
#      #     #    #              #         #      #     #                 #    #
#      #     #    #              #######   #      #     #                 #    #
#      #     #    #         #    #         #      #     #                 #    #
#      #     #    #         #    #         ##     #     #         #       #    #
#      #     #     ###      #    #         #      #     #   ##### #       #    #
#      #                    #    #                #          #    #       #    #
#      #                    #    #                           #    ####    #    #
#      #                    #    #                           #    #       #    #
#      #                    #    #                           #    #       #    #
####   #     ###    ####### #    #         ##########   #         #       #    #
#      #     #              #    #         #            #         #       #    #
#      #     #              #    #         #            #         #       #    #
#      #     #              #    #         #            #         #       #    #
################################################################################
