80 80
################################################################################
#   #               #    #                              #      #     #     #   #
#   #                    #                              #      #     #         #
#   #                    #                              #      #     #         #
#   #      #             ######################    #### #      #     #         #
#   #      #             #                     #        #      #     #         #
#   #      #   #### #    #                     #        #      #     #     #   #
#   #      #        #    #                              ###    #     #     #   #
#   #      #        #    #                              #      #     #     #   #
#   #      #        #    #########    ######### ####           #     #     #   #
#   #      #        #    #                                     #     #     #   #
#   #      #        #    #                     #               #     #     #   #
#   #      #        #    #                     #               #           #   #
#   #      #        #    #                                     #           #   #
#   #      #             ####    ############################# #           #   #
#   #      ##    ####### #       #         #              #    #           #   #
#   #      #     #       #       #         #              #    ###   #     #   #
#   #      #     #               #         #              #    #     #     #   #
#   #      #     #               #                             #     #     #   #
#   #      #     #               #                             #     #     #   #
#   #      #     #                                             #     #     #   #
#   #      #     #       #                                     #     #     #   #
#   #      #     #       #                 #                   #     #     #   #
#   #      #     #       #                 #    ############## #     #     #   #
#   #      #     #       #       #         #         #         #     ###    ####
#   #      #     #       #    ## #         #         #         #     #     #   #
#   #      #     #       #       #         #         #         #     #     #   #
#   #      #     #       #       #         #         #         #     #     #   #
#   #      #     #       #       #         #         #         #     #         #
#   #      #     #       #       #         #         #         #     #         #
#   #      #     #       #       #         #         #         #     #         #
#   #      #     #       #       #         #         ####      #     #         #
#   #      #     #       #       #         #         #         #               #
#   #      #     #       #       #         #         #         ############    #
#   #      #     #       #       #         #                   #      #    #   #
#   #      #     #       #       #         #                   #      #    #   #
#          #     #       #       #         #                   #      #    #   #
#          #     #       #       #         #                   #           #   #
#          #             #       ####      ##    ### #                     #   #
#          #             #       #         #         #                         #
#   #      #             #       #         #         #                         #
#   #      #             #       #         #         #                #        #
#   #      #     #       #       #         #         #         #      #        #
#   #   ## #     #       #       #                   #         #      #    #   #
#   #      #     #       #       ##################    ####### #      #    #   #
#   #      #     #    ## #       #                             #      #    #   #
#   #      #     #       #       #                             #      #    #   #
#   #      #     #       #       #                             #      #    #   #
#   #      #     #       #       #                             ####   #    #   #
#   #      #     #       #       ###########    #### #         #      ##    ####
#   #      #     #       #       #              #    #####     #      #        #
#   #      #     #       #       #              #    #         #      #        #
#   #      #     #       #       #              #    #         #      #        #
#   #      #     #       #       #              #    #         #      #        #
#   #      #     #       #       #                   #         #      #        #
#    ##### #     #       #       #                   #         #      #    #   #
#     #    #                                                   #      #    #   #
#     #    ########################    ####################### #      #    #   #
#     #    #                                                   #      #    #   #
#     #    #                                                   #      #    #   #
#     #    #                                                   #      #    #   #
#     #    #                                   *                               #
#     #    ##########################################    #######################
#     #    #    #     #            #                                           #
#     #    #    #     #            #                                           #
#     #    #    #     #            #                                           #
#     #    #    #     #            #                                           #
#     #    #    #    ##########    #                                           #
#     #    #                 #     ##########################################  #
#     #    #                                                             #     #
#     #    #                                                                   #
#     #    #                                                                   #
#          ######    ##                                                        #
#          #          #                                                        #
#          #          ############################    ##########################
#          #          #                   #                                    #
#     #    #    #     #                                                        #
#     #    #    #     #                                                        #
#     #    #    #     #                                                        #
################################################################################
