80 80
################################################################################
#            #                           #                         #           #
#                                        #                         #           #
#                                        #                   #     #    #      #
#   ######### ######################     #########    #      #          #      #
#      #                                 #      #     #                 #      #
#      #     #                           #      #     #########         #      #
#      #     #                           #      #     #                 #      #
#            #                #          #            #            #    #      #
#            #                #          #            #            #    #      #
#                                        #            #            #    #      #
########################    ############ #                         #    #   ####
#                     #    #             ####################      #    #      #
#                     #    #             #       #            #    #    #      #
#                     #    #             #       #            #    #    #      #
#                     #    #             #                    #    #    #      #
#    ################ #             #    #             #           #    #      #
#    #       #        #             #    #             #           #    #      #
#    #       #        #             #    #             #           #    #      #
#    #       #        #             #    #    ######## #           #           #
#    #       #        #######    ## #    #        #    #      #    #########   #
#    #       #        #     #       #    #        #    #      #    #    #      #
#    #       #        #     #       #    #        #    ###    #    #           #
#    #       #        #     #       #    #             #      #    #           #
#    #       #        #             #    #             #      #    #           #
#    #       #        #             #    #             #      #    #           #
#    #       #        #             #    #             #           #    #      #
#    #       #        #             #    ######   #    ##    ##### #    #    ###
#    #       #        #     #            #        #    #           #    #      #
#            #        #######    ####### #        #    #           #    #      #
#            #        #     #      #     #        #    #           #    #      #
#            #        #     #      #     #                                     #
#            ##    ## #     #      #     #################################    ##
#    #       #        #     #      #     #     #        #               #      #
#    #       #        ###   #      #     #     #        #               #      #
#    #       #        #     #      #     #     #        #               #      #
#    #       #        #     #      #     #     #        #               #      #
#    #       #        #     #      #     #              #               #      #
#    #       #        #     #      #     #                           *  #      #
#    #       #        #     #      #     #                              #      #
#    #       #        #            #     #                              #      #
#    ####    #        #            #     #     ##    ################## #      #
#    #       #        #            #     #     #                        #      #
#    #       #        #            #     #     #                        #      #
#    #       #        #     ##     #     #     #                        #      #
#            #        #     #      #     #     #              #         #      #
######    ## #        #     #      ##    #     #              #         #      #
#            #        #     #      #     #                              #      #
#            #        #     #      #     ############    ############## #      #
#            #        #     #      #     #     #    #    #      #       ##    ##
#            #        #     #      #     #     #    #    #      #       #      #
#  ###       #        #     #      #     #     #    #           #       #      #
#     #      #        #     #            #     #    #           #       #      #
#     #      #        #     #            #     #    #     ##    #       #      #
#     #      #        #     #            #     #    #                   #      #
#     #      #        #     #            #     #    #    #              #      #
#     #      #        #     #      #     #     #    #    #                     #
#     #      #        #     #      #     #     #    #    #                     #
#     #      #        #     #            #     #    #           #              #
#     #      #        #     #   ######## #          #    ###### #####          #
#     #      #        #     #     #                 #           #       #      #
#     #      #        #     #     #                 #           #       #      #
#     #      #        #     #     #                 #           #       #      #
#     #      #        #     #     #       #####     #    #      #       #      #
#     #      #        #     #     #      #    #     #    #      #       #      #
#     #      #        #     #     #      #    #     #    #      #       #      #
#     #      #        #     #            #    #     #    #      #       #      #
#     #      #        #     #            #    #     #    #      #       #      #
#     #      #        #     #            #    #          #      #       #      #
#     #      #        #     #            #    ##         #      #       #      #
#     #               #     #     #      #    #          #      #       #      #
#     #               #     #     #      #               #      #       #      #
#     #                     #     #      #          #    #      #       #      #
#     #                     #     #      #          #    #              #      #
#     #      #              #     #      #          ##    ############# #      #
#     #      #              #     #   ## #    #     #      #            #      #
#     #      #        #     #     #      #    #     #                   #      #
#     #      #        #     #     #      #    #     #                   #      #
#     #      #        #     #     #      #    #     #                   #      #
################################################################################
