80 80
################################################################################
#   #           #     #    #        #                         #     #     #    #
#   #           #     #    #        #                         #     #     #    #
#   #      #    #     #    #        #                         #     #     #    #
#   #      #    #     #    ###    ##         #       #        #     #     #    #
#          #    #     #                      #       #        #     #     #    #
#          #    #     #                      #                #     #     #    #
#          #    #     #                      ###########    ##      #     #    #
#          #    #     #             #        #         #            #     #    #
#   #      #    #     #             ##    ## #         #            #     #    #
#   #      #    #     #####    #### #        #                      #     #    #
#   #      #    #     #    #        #        #                #     #     #    #
#   #      #    #     #    #        #        #                #           #    #
#   #      #    #     #    #        #                         #           #    #
#   #      #    #                   ##############    ####### #           #    #
#   #      #    #                   #          #              #           #    #
#   #      #    #                   #          #              #           #    #
#   #      #    #                   #          #              ########    #    #
#   #      #    #     #    #        #                         #      #    #    #
#   #      #    #     #    #        #                         #      #    #    #
#   #      #    #     #                                       #      #    #    #
#   #      #    #     #########################    ########## #      #    #    #
#   #      #    #     #                  #               #    #      #    #    #
#   #      #    #     #                  #               #    ###    #    #    #
#   #      #    #     #                                  #    #      #    #    #
#   #      #    #     #                                  #    #      #    #    #
#   #      #    #     ################    #########      #    #      #    #    #
#   #      #    #     #                                       #      #    #    #
#   #      #    #     #                  #                    #      #    #    #
#   ####   #    #     #                  #                    #      #    #    #
#   #      #    #     #                                       #      #    #    #
#   #      #    #     ############################    ## #    #      #    #    #
#   #      #    #     #          #    #          #       #    #      #    #    #
#   #      #    #     #          #    #          #       #    #      #    #    #
#   #      #    #     #               #          #       #    #      #    #    #
#   #      #    #     #               #          #       #    #      #    #    #
#   #      #    #     #               ######    ####     #    #      #    #    #
#          #    #     #               #                  #    #      #         #
########   #    #     #          #    #                  #    #      #         #
#     #    #    #     #######    #### #                  #    #      #         #
#     #    #    #     #        #      #                  #    #      #        ##
#     #    #    #     #        #      #                  #    #      #    #    #
#     #    #    #     #        #      #########    ##### #    #      #    #    #
#     #    #    #     #        #           #             #    #      #    #    #
#     #    #    #     #   #### #   ###     #             #    #      #    #    #
#     #    #    #     #        #           #             #    #      #    #    #
#     #    #    #     #        #           #             #    #      #    #    #
#     #    #    #     #               #    #   ######### #    #      #    #    #
#     #    #    #     #               #    #       #     #    #           #    #
#     #    #    #     #               #                  #    #           #    #
#     #    #    #     #               #                  #    #           #    #
#     #    #    #     #               #                  #    #           #    #
#     #    #    #     #                                                   #    #
#     #    #    #     #   ############################################### #    #
#     #    #    #     #         #    #                #                   #    #
#     #    #    #     #         #    #                #                   #    #
#          #    #     #         #    #                                    #    #
#          #    #     #              #                                    #    #
#          #    #     #              #                                    #    #
#########    ## #     #       *      #######    ######################### #    #
#       #       #     ##    ######## #                 #                  #    #
#       #       #     #              #                                    #    #
#       #       #     #                                                   #    #
#       #       #     #                                                   #    #
#       #       #     #                                                   #    #
#       ##      #     #                                                   #    #
#       #       #     ##################################################    ####
#       #       #     #      #                             #                   #
#       #       #     #      #                                                 #
#       #       #     #                                                        #
##    ##        #     #                                                        #
#                     #           #                                            #
#                     #           #########################    #################
#                     ########    #                                            #
#       #             #           #                                            #
####    ############# #           #                                            #
#                     #           #                                #           #
#                     #      #    #                                #           #
#                     #      #    #                                #           #
################################################################################
