80 80
################################################################################
#       #         #      #    #       #         #    #     #               #   #
#       #         #      #    #       #         #    #     #               #   #
#       #         #      #    #       #         #    #     #                   #
#       #         #      #    #       #         #    #     #                   #
#       #         #      #    #       #         #    #     #                   #
#       #                     #       #         #    #     #                   #
#       #                     #       #         #    #     ##################  #
#       #                     #       #         #    #     #     #        #    #
#       #                     #       #         #    #     #     #        #    #
#       #         #      #            #         #    #     #     #             #
#       #         #      #            #         #    #     #     #             #
#       #         #      #                      #    #     #     #             #
#       #         #      #                      #    #     #     #             #
#       #         #      #    #                 #    #     #     #        #    #
#       #         #      #    #                 #    #     #      ##      #    #
#####   #         #      #    #       ####      #    #     #              #    #
#       #         #      #    #       #         #    #     #              #    #
#       #         #      #    #       #         #    #     #              #    #
#       #         #      #    #       #         #    #     #     #        #    #
#       #         #      #    #       #              #     #     #        #    #
#       #         #      #    #       #                    #     #        #    #
#       #         #      #    ###     #                    #     #        #    #
#       #         #      #    #       #                    #     #        #    #
#       #         #      #    #       #         #          #     #        #    #
#       #         #      #    #       #         #    #     #              #    #
#       #         #      #    #       #         #    #     ###########    #    #
#       #         #      #    #       #         #    #     #       #      #    #
#       #         #      #    #       #         #    #     #       #      #    #
#       #         #      #    #                 #    #     #       #      #    #
#       #         #      #    #    ############ #    #     #       #      #    #
#       #         #           #    #     #      #    #     #       #      #    #
#       #         ###    #### #    #     #      #    #     #       #      #    #
#       ######    #           #    #     #      #    #     #       #      #    #
#       #         #           #    #     #      #    #     #       #      #    #
#       #         #           #    #     #   ## #    #     #       #      #    #
#       #         #           #    #     #      #    #     #       #      #    #
#       #         #           #    #            #    #     #       ##     #    #
#                 #    #      #    #            #    #     #       #      #    #
#                 #    #      #    #            #    #     #       #      #    #
#                 #    #      #    #            #    #     ####    #      #    #
#                 #    #      #    #            #    #     #       #      #    #
#                 #    #      #    #            #          #       #      #    #
#                 #    #      #    ##    ###### ######     #       #      #    #
###    ########## #    #      #    #       #    #     #    #       #      #    #
#      #     #    #    #      #    #       #    #     #    #       #      #    #
#      #     #    #    #      #            #    #     #    #       #      #    #
#      #     #    #    ####   #            #    #     #    #       #      #    #
#      #          #    #      #            #    #     #    #       #      #    #
#      #          #    #      #            #    #     #    #       #      #    #
#  ### #   ##     #    #      #    #            #     #    #       #      #    #
#      #          #    #      #    #            #          #       #      #    #
#      #     #    #    #      #    #            #          #       #      #    #
#      #     #    #    #      #    #            #          #       #      #    #
#      #     #    #    #      #    #       #    #          #       #      #    #
#       ###    ## #    #      #    #       #    #     #    #       #      #    #
#                 #    #      #                       #    #       #      #    #
#                 #    #      ########################     #       #*     #    #
#                 #    #      #              #             #       #      #    #
#      #     #    #    #      #              #             #       #      #    #
#      #     #    #    #      #              #                     #      #    #
#            #                #              #                     #      #    #
###########    ############## #   ########## #    #                #      #    #
#       #                     #    #              #                       #    #
#                             #    #              #        #              #    #
#                             #    #          ####    #### #              #    #
#                             #    #                       #              #    #
###      #######    ######### #    ###    ## #             #       #      #    #
#       #                     #              #             #       #      #    #
#       #                     #              #        #    #       #      #    #
#       #                     #              #        #    #       #      #    #
#                             #                            #       #      #    #
###########################    ########################### #       #      #    #
#                        #                                 #       #      #    #
#                        #                                 #       #      #    #
#                        #                                 #       #      #    #
#                                                          #       #      #    #
#                                                          #       #      #    #
#                                                          #       #      #    #
################################################################################
