80 80
################################################################################
#   #         #    #      #       #       #     #                              #
#   #         #    #      #       #       #     #                              #
#   #         #    #      #       #       #     #                 #            #
#   ####      #    #      #       #       #     #                 #            #
#   #         #    #      #       #             #    ##   ####### ##########   #
#   #         #    #      #    ## #             #     #           #            #
#   #         #    #      #       ###           #     #           #            #
#   #              #      #       #             #     #           #            #
#   #              #      #       #       #     #     #                        #
#   #              #      #       #       #     #     ####################    ##
#   #              #      #       #       #     #     #                        #
#   #         #    #      #       #             #     #                        #
#   #         #    #      #       #    ######## #     #                        #
#   #         #    #      #       #             #     #                  #     #
#   #              #      #       #                   ################   #     #
#   #    ######### #      #       #                   #                  #     #
#                  #      #                           #                  ###   #
#                  #                    #             #                  #     #
#                  #                    #       #     #                  #     #
#                  #                    #       #     #          #       #     #
#   #        #     #              #             #     #          #       #     #
#   #        #     #   ## ####    ############# #                              #
#   #   #### #     #      #               #     #    ###########################
#   #        #     #      #               #     #      #                       #
#   #        #     #      #                     #      #                       #
#   #        #     #      #                     #      #                       #
#   #        #     #      #                     #      #                       #
#   #        #     #      #                     #      ##############    #######
#   #        #     #                            #      #      #                #
#   #        #     #########################    #      #      #                #
#   #        #     #                   #        ##                             #
#   #        #     #                   #        #                              #
#   #        #     #                   #        #       ###                    #
#   #        #     #                   #        #              #####    ########
#   #        #     #                   #        #      #      #                #
#   #        #     #                            #      #      #                #
#   #        #     #                            #      #      #                #
#   #        #     #                                                           #
#   #        #     ######################    ###################################
#                  #    #           #      #                                   #
#####    ######### #    #                  #                                   #
#          #       #    #                  #                                   #
#          #       #                       #                                   #
#          #       #                       ########    ##### ##    #############
#   #      #       #                #      #                 #                 #
#   #      #       #                #      #                 #                 #
#   #      #       ########    #### ###    #                 #                 #
#   #      #       #    #           #      #                                   #
#   #      #       #    #           #      #################################   #
#   #      #       #                #      #          #                        #
#   #      #       #                #      #                                   #
#   #      #       #                #      #                                   #
#   #      #       #                       #                               #   #
#   #      #       ############    ####### #    #                          #   #
#   #      #       #    #     #       #    #    #     ##################    ####
####    ## #       #    #     #       #    #    #     #    #    #       #      #
#   #      #       #    #     #       #    #    #     #    #            #      #
#   #      #       #    #     #       #    #          #    #            #      #
#   #      #       #    #     #       #    #    ##### #    #            #      #
#   #      #       #    #     #       #    #    #     #    #            #      #
#   #      #       #    #     #       #    #    #     #    #    #       #      #
#   #      #       #    #     #       #    #    #     #         #       #      #
#   #      #       #    ###   #       #    #    #     #         #       #      #
#   #      #       #    #             #    #    #     #         #       #      #
#   #      #       #                            #     #         ##      #      #
#   #      ##      #                            #     #    #### #       #   ####
#   #      #       #                            #     #      *  #       #      #
#   #      #       #    ##### ##    ##          #     #         #       #      #
#   #      #       #    #     #       #    #    #     #         #       #      #
#   #      #       #    #     #       #    #    #     #         #       #      #
#   #      #       #    #     #       #    #    #     #         #       #      #
#   #              #          #       #    #    #     ##########    ### #      #
#   #                         #       #    #          #                 #      #
#   #                         #       #    #          #                 #      #
#   #                         ########     #          #                        #
#          #            #     #            #          #         #              #
#          #       #    #     #            #    #     #         #              #
#          #       #    #     #            #    #     #         #              #
################################################################################
