80 80
################################################################################
#      #                                        #       #                  #   #
#                                               #       #                  #   #
#                                               #       #                      #
#                                               #       #           #          #
#                                               #       #           #          #
#                                               #       #           #          #
#                                               #       #                  #   #
#############################    ############## #       ####    ########## #   #
#     #         #                #         #    #       #           #      #   #
#     #                          #         #    #       #           #      #   #
#     #                          #         #    #       #                  #   #
#     #                               #    #    #       #                  #   #
#     #                               #    #    #       #                  #   #
#     #                               #    #    #       #                  #   #
#     #                               #    #    #       #                  #   #
#     #############    ######### #    #    #    #       #                      #
#     #       #      #    #      #    #         #       #####    ###############
#     #       #      #    #      #    #         #       #    #      #     #    #
#     #       #      #    #      #    #         #       #    #            #    #
#     #       #      #    #      #    #         #       #    #            #    #
#     #                   #      #    #    #            #    #            #    #
#     #                          #    #    #            #    #            #    #
#     #    ###                   #    #    #            #    #####    #### ##  #
#     #                          #    #    #            #    #                 #
#     #       #      #           #    #    #    #       #    #                 #
#     #       #      #    #      #    #    #    #    ## #    #                 #
#     #       #      #    #      #    #    #    #       #    #                 #
#     ########    ## #    #      #    #    #    #            ###    ############
#     #              #    #      #    #    #    #            #                 #
#                    ##    ##### #    #    #    #            #                 #
#                    #           #    #    #    #            #                 #
#                    #           #    #    #    #       #    #          #      #
#          #         #           #    #    #    #       #    #####      #      #
#     #    #         #           #    #    #    #       #    #          #      #
#     #                               #    #    #       #    #          ##    ##
#     ########    ################### #    #    #       #    #          #      #
#     #                               #    #    #       #               #      #
#     #                               #    #    #       #               #      #
#     #                               #    #    #       #         #     #      #
#     #      #                        #    #    #       #         #     #      #
#     #      ##############    ###### #    #    #                              #
#     #      #                        #    #    ###    #########################
#     #      #                        #    #    #     #     #        #         #
#     #      #                        #    #    #     #     #                  #
#     #      #                        #    #    #     #     #                  #
#     #   ## #########    ### ####    #    #    #     #                        #
#     #      #               #        #    #    #     #                        #
#     #      #               #        #    #    #     ###    #####    ##########
#     #      #               #        #    #    #     #                        #
#                                     #    #    #     #     #                  #
#####################    ############ #    #    #     #     #                  #
#   #      #                          #    #    #     #     #                  #
#   #      #                          #    #    #     #                        #
#   #      #                          #    #    #     ####################    ##
#   #      #                          #         #     #      #                 #
#   #      #                  ####    #   ##### #     #      #                 #
#          ######    ######## #       #    #    #     #      #                 #
#          #            #     #       #    #    #     #      #                 #
#          #                  #       #    #    #     #      #####    ### ###  #
#          #                  #       #    #    #     #      #            #    #
#   #      #                  #       #    #    #     #      #            #    #
#   #      #                          #    #    #            #            #    #
#   #      ###############    ####### #    #    #            #            #    #
#   #      #          #               #    #    #            ##########    #####
#   #      #                          #    #    #                        #     #
#   #      #                          #    #    #     #                  #     #
#   #                                 #    #    #     #                  #     #
#   #       ##    ####      ######### #    #    #     #             #    #     #
#   #                 #               #    #    #     #      #      #    #     #
#   #                 #               #    #    #     #      #      #     ##   #
#   #                 #               #    #    #     #      #      #          #
#   #                                 #    #    #     #      ###    #          #
#   ###########    ################## #    #    #     ####   #      #          #
#   #                     #           #    #    ###   #      #      #          #
#   #                                 #    #    #     #      #      #   ########
#   #                                 #    #    #     #      #      #          #
#   #                      *          #         #     #      #      #          #
#   #                                 #         #     #      #      #          #
################################################################################
