80 80
################################################################################
#   #     #    #      #    #     #             #    #    #    #          #     #
#   #     #    #      #    #     #             #         #    #          #     #
#   #     #    #                 #        #    #         #    #    #     #     #
#   #          #                 #        #    #         #    #    #     #     #
#   #          #                 ##    ## #    #         #    #    #     #     #
#   #          #                 #        #    #    #    #    #    #     #     #
#   ########   #      #    #     #        #    #    #    #    #    #     #     #
#   #     #    #      #    #     #        #    #    #    #    #    #     #     #
#   #     #    #      #    #     #             #    #    #    ##    #### #     #
#   #     #    #      #####      ####    ##### #         #    #     #    #    ##
#   #     #    #      #    #     #        #    #   ##### #    #     #    #     #
#   #          #      #    #     #        #    #    #    #    #     #    #     #
#   #          #      #    #              #    #    #    #    #     #    #     #
#   #          #   ## #                        #    #    #    #     #    #     #
#   #          #      #                        #         #    #          #     #
#   #     #    #      #                        #         #               #     #
#   #     #    #      ################    #### #         #     ##        #     #
#   #     #    #      #    #         #         #                         #     #
#   #     #    #      #    #         #                              #    #     #
#   #     #    #      #    #                                  #     #    #     #
#   #     #    #      #    #                    ##########    #     #    #     #
#   #     #    #      #    #              #         #         #     #    #     #
#   #     #    #      #    #              #    #              #     #    #     #
#   #     #    #      #    ####    ###### #    #              #     #    #     #
#   #     #    #      #    #              #    #              #     #    #     #
#   #     #    #      #    #              #    #              #     #    #     #
#   #     #    #      #    #              #    #                         #     #
#   #     #    #      #    #                   ##    ################### #     #
#   #     #    #      #    #####    ########## #      #     #            #     #
#   #     #           #    #        #    #     #      #     #            #     #
#   #     #           #    #        #    #     #      #     #            #     #
#   #     #           #    #        #    #     #      #             #    #     #
#   #     #           #    #        #    #     #                    #    #     #
#   #     #           #    #        #          #                    #    #     #
#   ####    ######### #    #                   #                         #     #
#   #     #           #    #                   #            #    ####### #     #
#         #           #    #                   #   ######## #            #     #
#         #           #    #                   #       #    #            #     #
#                     #    #   #### #          #       #    #            #     #
#                     #    #        ######     #            #            #     #
#   #                 #    #        #    #     #            #    #       #     #
#   #                 #    #        #    #     #            #    #             #
#   #                 #    #        #    #     #   ####     #    #             #
#                     #    #        #    #     #       #    #    #    ###      #
###############    ## #    #        #    #     #       #    #    #             #
#             #       #    #        #    ###   #       #    #    #       #     #
#             #       #    #        #          #       #    #    #       #     #
#             #       #             #          #       #    #    #       #     #
#                     #             #          #       #    #    #       #     #
#                     #                                                  #     #
########    ## ###    ###################    ########################### #     #
#                     #                                                  #     #
#             #       #                                                  #     #
#             #       #                                                  #     #
#                                                                        #     #
###########################################    ######################### #     #
#           #               #                                            #     #
#           #               #                                            #     #
#                           #                                            #     #
#                           #       #                                    #     #
#                           ####    #                                    #     #
#                           #       #   ################################ #     #
#                           #       #                                    #     #
##    ##################### #       #                                    #     #
#            #              #       #                                    #     #
#            #              #                                            #     #
#            #              #####################    ################### #     #
#            #      #       #                   #                        #     #
###    ##### #      ##      #                   #                        #     #
#       #    #      #       #                   #                        #     #
#            #      #       #                   #                        #     #
#            #      #       #                   ####    ################ #     #
#            #              ############    ### #                     *  #     #
#  #####     ##    ######## #                   #                        #     #
#       #              #    #                   #                        #     #
#       #              #                                   #             #     #
#       #                                                  #             #     #
#       #                          #                       #             #     #
################################################################################
