80 80
################################################################################
#                     #                      #                     #    #      #
#                     #                                            #    #      #
#     #               #                                            #    #      #
#     ######    ##### #                                            #    #      #
#     #                                                            #    #      #
#     #                                                            #    #      #
#     #                ###########    ############################ #    #      #
#                                                    #             #    #      #
##################    #                              #             #    #      #
#               #     #                                            #    #      #
#                     #                                            #    #      #
#                     #                                            #    #      #
#                     #                                            #    #      #
#                                                                  #    #      #
##############    ################################################ #    #      #
#                  #             #        #          #     #       #    #      #
#                  #             #        #          #     #       #    #      #
#                  #             #        #          #     #       #    #      #
#                                #        #          #     #       #    #      #
#                                ##    ## ##    #### #             #    #      #
#                                #        #          #             #    #      #
#                                #                   #             #    ###    #
#   ############################ #                   #             #    #      #
#      #     #      #            #                   #######    ## #    #      #
#      #     #      #            ############    ### #     #       #           #
#            #      #            #      #            #     #       #           #
#            #      #            #      #            #     #       #           #
#            #   ### ######      #      #            #     #       ##########  #
#            #                   #      #            #     #       #     #     #
#   ## #     #                   #      ####    ##   ##            #     #     #
#      #     #                   #             #                   #     #     #
#      #     #                   #             #            ####   #     #     #
#      #     ###########    #### ###           #                   #     #     #
#      #     #      #     #      #                         #       #     #     #
#      #     #      #     #      #      ###    ##### #     #       #     #     #
#      #     #      #     #      #      #            #     #      *#     #     #
#            #      #     #      #      #            #     #             #     #
#    ####### #      #     #      #      #            #     #             #     #
#   #        #      #     #      #                         #             #     #
#   #               #     #      #########################    #####      #     #
#   #               #            #     #     #    #        #       #     #     #
#   #               #            #     #     #    #        #       #     #     #
#   #                            #     #     #    #        #       #     #     #
#   #        #                   #     #     #    #        #       #     #     #
#   #        #            #      #     #     #    #        #       #     #     #
#   #        #            #      #     #     #    #        #       #           #
#   #        #      #     #      #     #     #    #        #       #           #
#   #        #      #     #      #     #     #             #       #           #
#   #        #      #     #      #     #     #             #       #           #
#   #        #      #     #      #     #           ####    #    ## #     #     #
#            #      #     #      #     #                   #       #     #     #
#            #      #     #      #     #          #        #       #     #     #
#            #      #     #      #     #          #        #       #     #     #
#            #      #     #      #     #     #    #        #       #     #     #
#   #        #      #     #      #     #     #             #       #     #     #
#   #        #      #     #      #     #     ########      #       #     #     #
#   #        #      #     #      #     #     #                     #     #     #
#   #   #### #      #     #      #           #                     #     #     #
#   #        #      #     #      #           #                     #     #     #
#   #        #      #     #      #           #                     #     #     #
#   #        #      #     #      #           #    #                #     #     #
#   #        #      #     #      #     #     ######    ########### #     #     #
#   #        #      #     #      #     #     #                #    #     #    ##
#   #        #      #     #      #     #     #                #    #     #     #
#   #        #      #     #      #     #     #                #    #     #     #
#   #        #      #     #      #     #     #                #    #     #     #
#   #        #      #     #      #     #     #    #           #    #     #     #
#   #        #######      #      #     #     #    #           #    #     #     #
#   #        #      #     #      #     #     #                #    #     #     #
#   #        #      #     #      ######      ##########    ## #    #     #     #
#   #        #      #     #      #           #     #               #     #     #
#   #        #            #      #           #                     ###   #     #
#   #        #            #    ##            #                     #     #     #
#   #        #    ##      #                  #                     #     #     #
#   #        #            #           ###    ##         ##### #    #     #     #
#   #        #      #     #           #      #     #          #    #     #     #
#   #        #      #     #      #    #      #     #          #    #     #     #
#   #        #      #     #      #    #      #     #          #    #     #     #
################################################################################
