80 80
################################################################################
#                         #            #                                       #
#                         #            #                                       #
#                         #            #                                       #
#                         #      #     #                                       #
#                         #      #     #                                #      #
########    ############# #####    #### ########    ################### #      #
#    #    #     #    #    #                                  #          #      #
#    #    #          #    #                                  #          #      #
#    #    #          #    #                                  #          #      #
#    #    #          #    #            #                     #          #      #
#         #          #    ##    ###    ###############    ## #####      #      #
#         #     #    #    #      #     #                     #          #      #
#         #     #    #    #      #     #                                #      #
#         #     #    #    #      #     #                                #      #
#    #    ####    ## #    #                                             #      #
#    #    #     #    #    ######################################    ### #      #
##    ### #     #         #                                   #    #    #      #
#   #     #     #         #                                   #    #    #      #
#   #     #     #         #                                   #    #    #      #
#   #     #     #         #                       #           #    #    #      #
#   #     ###   #    #    #                       #           #    #    #      #
#   ##    #     #    #    #                       #           #    #    #      #
#   #           #    #    ######################    ######### #    #    #      #
#   #           #    #    #      #                    #       #    #    #      #
#               #    #    #      #                    #       #    #    #      #
#                    #    #      #                    #       #    #    #      #
#         #          #    #      #                    #       #    #    #      #
#         #          #    #      #                    #       #    #    #      #
#                    #    #                           #       #         #      #
#################    #    #                           #       #         #      #
#      #        #    #    #                           #       #         #      #
#      #        #    #    ####    ################### #       #         #      #
#      #        #    #    #                    #      #       #    #    #      #
#               #    #    #                    #      #       #    #    #      #
#               #    #    #                    #      #       #    #    #      #
#               #    #    #                    #      #       #    #    #      #
#    ##         #    #    ###############      ###    #            #    #      #
#      #    ### #    #                         #      #            #    #      #
#      #        #    #                         #      #            #    #      #
#      #        #    #                         #      #            #    #      #
#      #        #    #                         #              #    #    #      #
#      #             #    ###    ### ##    ### #              #    #    #      #
#      #             #    #     #    #         #              #    #    #      #
#                    #    #     #    #         #              #    #    #      #
##    ##########     #    #     #    #         #      #       #####     #      #
#     #    #    #    #    #          #         #      #   ### #    #    #      #
#               #    #    #          #         #      #       #    #    #      #
#               #    #    #          #         #      #       #    #    #      #
#               #    #    #          #                #       #    #    #      #
#               #    #    #     #    #                #       #    #    #      #
#          #    #    #    #     #    #                #       #         #      #
#    ##### #    #    #    #     #    #                #       #         #    ###
#          #    #    #    #     #    #         #      #       #         #      #
#          #    #    #    #     #    #         #      #       #         #      #
#          #    #    #    #     #    #         #      #       #         #      #
#                            *                                          #      #
########################################################    ########### #      #
#   #        #       #                                             #    #      #
#   #        #       #                                             #    #      #
#   #        #       #                                             #    #      #
#            #       #    #                                        #    #      #
#            ####    #    ###################################      #    #      #
#            #            #                   #                    #    #      #
#            #            #                                        #    #      #
#            #            #                                        #    #      #
#            #            #                                             #      #
########     #            #                                             #      #
#     #      #####    ### #                   #                         #      #
#     #      #      #     #                   #                         #      #
#     #      #      #     #                                             #      #
#            #      #     ####################################    ##### #      #
#                         #                                             #      #
#                         #                                             #      #
#                         #                                             #      #
######################    #                     #                       #      #
#                         #                     #                       #      #
#                         #                     #                       #      #
#                         #                     #                       #      #
################################################################################
