80 80
################################################################################
#       #    #    #     #      #            #      #    #      #               #
#            #          #      #            #      #           #               #
#            #          #      #            #      #           #               #
#  #####     #          #      #            #      #           #               #
#            #          #      #    ####    #      #           ##    ## ###    #
#       #    #    #     #      #    #       #      #    #      #        #      #
#       #    #    #     #   ## #    #       #      #    #      #        #      #
#            #    #     #           #       #      #    #      #        #      #
#  ######### #    #     #           #       #      #    #      #        #      #
#       #    #    #     #           #       #      #    #      #        #      #
#            #    #     #           #       #      #    #      #        #      #
#            #    #     #      #    #       #      #    #      #               #
#                 ##    #      #    #       #      #    #      ###    ##########
#                 #     #      #            #      #    #      #         #     #
#       #         #     #      ########    ##      #    #      #         #     #
#       #         #     #      #                   #    #                #     #
#       #    #    #     #      #                   #    #                #     #
#       #    #    #            #                   #    #       ###      #     #
#       #    #    #            #                   #    #                #     #
#####   #    #    #            ##############      #           #         #     #
#       #    #    #            #                   #########   #         #     #
#       #    #    #     #      #                   #    #      #         #     #
#       #    #    #     #      #                   #    #      #         #     #
#       #         #     #                          #    #      #         #     #
#####    ######## #     #########    ############# #    #      #         #     #
#   #      #      #     #            #      #      #    #      #         #     #
#   #      #      #     #            #             #    #      #         #    ##
#   #      #      #     #            #             #    #      #         #     #
#   #      #      #     #            #             #    #      #               #
#    ###   #      #     #######      #             #    #      #               #
#          #      #     #            #      #      #           #               #
#          #      #     #            #      #      #           #               #
#          #      #     #            #      #      #           #         #     #
#   #      #      #     #    #        ##    #      #           #         #     #
#   #      #      #     #    #    ###       #      #    ###    #         #     #
#          #      #     #    #       *      #      #    #      #         #     #
######     ###    #     #    #              #      #    #      #         #     #
#   #      #      #     #    #              #      #    #      #         #     #
#   #      #      #     #                   #      #    #      #         #     #
#   #      #      #     ########    ####### #      #    #      #         #     #
#   #      #      #     #      #    #       #      #    #      #         #     #
#   #      #      #     #      #    #       #      #    #      #         #     #
#   #      #      #     #      #    #       #      #    #      #         #     #
#   #   ###       #     #      #            #      #    #      #         #     #
#   #             #     #      #            #      #                     #     #
#   #             #     #      #            #      ######################    ###
#   #             #     #      #   ######## #      #       #     #       #     #
#          #      #     #      #    #       #      #       #     #       #     #
#          #      #     #      #    #       #      #       #     #             #
#          #      #     #      #    #       #      #       #     #             #
#          #      #     #      #    #       #              ###   #             #
#                 #     #      #    #       #              #     #             #
################    ### #      #    #       #           ## #     ######    #####
#    #       #     #    #           ##      #              #     #       #     #
#    #       #     #    #           #       #      #             #       #     #
#    #       #     #    #           #       #      #             #             #
#    #       #     #    #           #       #      #             #             #
#    #       #     #    #   ## #    #       #      #####    #### #        ###  #
##   #       #     #    #      #            #      #       #                   #
#    ####          #    #      #            #      #       #         ### #     #
#    #             #    #      #            #      #                     #     #
#    #             #    #      #            #      #                     #     #
#    #             #    #      #    #       #      #             #       #     #
#    #             #    #      #    #       #      #             #       #     #
#     #######      #    #      #                                               #
#                       #####    ###############################################
#                       #        #                   #      #                  #
#                       #        #                   #      #                  #
#    #                  #                            #      #                  #
#    #       #     #    #                            #      #                  #
#    #       #     #    #                            #      #                  #
#    #       #     #    #                            #                         #
#    #                  ####################    #####                          #
#    #   ############## #                                                      #
#    #             #    #                             #########    #############
#    #                  #                                                      #
#    #                  #          #                 #                         #
#    #                  #          #                 #                         #
################################################################################
