80 80
################################################################################
#                         #               #      #                             #
#                         #               #      #                             #
#                                         #      #                             #
#                                                #                             #
####    ##################                       #                             #
#            #     #                             #############    ##############
#                  #      #####    ############# #        #    #         #     #
#                         #                 #    #        #    #         #     #
#     #                   #                 #    #        #    #         #     #
#     #                   #                 #    #        #    #    #    #     #
#     #####    ####       #        #        #    #        #         #    #     #
#     #            ####   #        #        #    #        #         #    #     #
#     #            #      #        #   #### #    #        #         #    #     #
#     #            #      #        #        #    #        #              #     #
#     #            #      ##    ## #             #        #    ######    #     #
#     #      #     #      #        #             #        #    #    #    #     #
#     #      #            #        #             #    ### #    #    #    #     #
#     ####    ########### #        #   ######### #        #    #    #    #     #
#     #                   #        #             #        #    #    #    #     #
#     #                   #        #             #        #    #    #    ####  #
#     #                   #        #             #        #    #    #    #     #
#     #                   #        #        #    #        #    #         #     #
#     #                   #        #        #    #        #    #         #     #
#                                                #        #    #         #     #
#    ########################################### #        #    #         #     #
#      #    #              #         #           #        #    #         #     #
#      #    #              #                     #        #              #     #
#      #    #              #                     #         ###########   #     #
#      #    #        #     #                     #                #      #     #
#      #    #        #     ##    #### ###    ### #                #      #     #
###    #    #              #         #           #                #      #     #
#      #    #    ######### #         #           #        #              #     #
#      #    #      #       #         #           #        #              #     #
#      #    #      #       #                     #                       #     #
#      #    #      #       ##################    #   ################### #     #
#      #    #      #       #         #           #      #          #     #     #
#           #      #       #                     #      #          #     #     #
#           #                                    #      #          #     #     #
#           #                                    #      #    #     #     #     #
#           #                                    #      #    #     #     #     #
#      #     ###    ############################ #      #    ###   ###   #     #
#      #              #      #     # *     #     #      #    #     #     #     #
#      #              #      #     #       #     #      #    #     #     #     #
#      #                     #     #       #     #      #    #     #     #     #
#######    ##                #     #             #      #    #     #     #     #
#    #      #                #     #             #      #          #     #     #
#    #      #                #     #             #      #    ##### #     #     #
#    #      #                ##    ########      #      #    #     #     #     #
#    #      #    ########### #     #       #     #      #    #     #     #     #
#    #      #     #    #     #     #       #     #      #          #     #     #
#    #      #     #    #     #     #       #     #      #          #     #     #
#    #      #     #    #     #     #       #     #      #     ##   #     #     #
#    #      #     #    #     #     #       #     #      #          #     #     #
#    #      #     #    #     #     #       #     #      #    #     #     #     #
#    #      ###        #     #     #       #     #      #    #     #           #
#    #      #          #     #     #       #     #      #    #                 #
#    #      #          #     #     #       #     #      #    #                 #
#    #      #          #     #     ###           #      #    #                 #
#    #      #          #     #     #             #      #    #           #     #
#    #      #          #     #     #             #      #                #     #
#    #      #######          #     #             #      #   ############ #     #
#    #      #     #          #     #       #     #      #      #    #    #     #
#    #      #     #          #     #       #     #      #      #    #    #     #
#           #     #          #     #       #     #      #      #    #    #     #
#           #     #    #     #     #       #     #      #           #    #     #
#           #     #    #     #     #       #     #      #           #    #     #
#           #          #     #             #     #                  #    #     #
#    #      #          #                   ###   #                  #    #     #
#    #      #          #                   #                   #    #    #     #
#    ###    #                              #                   #         #     #
#    #      ###############    ### #       #            #      #         #     #
#    #      #         #            #       #            #      #         #     #
#    #      #         #            #       #     #      #      #         #     #
#    #      #         #            #       #     #      #####    ## #    #     #
#    #      #         #            #       #     #      #    #      #    #     #
#    #      #                      #       #     #      #    #      #    #     #
#    #      #                      #       #     #      #           #    #     #
#    #      #                      #       #     #      #           #    #     #
################################################################################
