80 80
################################################################################
#     #     #    #      #     #    #              #                   #        #
#     #     #    #      #          #              #                   #        #
#     #          #      #          #              #                   #        #
#     #          #      #          ####    ###### #                   #        #
#     #          #                                ##    ############# #        #
#     #          #            #                   #     #             #        #
#     #     #    #            #                   #     #             #        #
#     #     #    ##    ###### #                   #     #             #        #
#     #     #    #            ##    ##############      #     #       #        #
#     #     #    #            #                        ##     #       #        #
#     #     #    #            #                               #       #        #
#     #     #    #            #                               #       #        #
#     #     #    #                                #           #       #        #
#     #     #    #################    ########### #           #       #        #
#     #     #    #                    #           #    ###### #       #        #
#     #     #    #                    #           #     #     #       #        #
#     #     #    #                    #           #     #     #       #        #
#     #     #    #                    #           #           #####   #        #
#     #     #    #################    ###    #### #           #       #        #
#     #     #    #                                #           #       ####    ##
#     #     #    #                                #           #       #        #
#     #     #    #                                #           #       #        #
#     #     #    #                                                    #        #
#     #     #    #################    ############################### #        #
#     #     #    #                   #       #                        #        #
#     #     #    #                   #       #                        #        #
#     #     #    #                   #       #                        #        #
#     #     #    #                           #                                 #
#     ###   #    #                                                             #
#     #     #    ###########    #####                                          #
#     #     #    #      #                                                      #
#     #     #    #      #         *  #                                #        #
#     #     #    #                   #                                #        #
#     #     #    #           #       #######################    ##### #        #
#     ####    ## #           #       #     #                          #        #
#           #    #    ##             #     #                          #        #
#           #    #      #   ######## #                                #        #
#           #    #      #            #                                #        #
#           #    #      #            #                                #        #
#     #     #    #      #            #                                #        #
#     #     #    #                                                             #
#     #     #    ###############    ############################################
#     #     #    #                                                     #       #
#     #     #    #                                                     #       #
#     #     #    #                                                     #       #
#     #     #    #                          #                          #       #
#     #     #    #######    ### #     #     ############    ########## #       #
#     ##    #    #        #     #     #     #         #                #       #
#     #          #        #     #           #         #                #       #
#     #          #        #     #########   #         #                #       #
#     #          #              #      #    #                          #       #
#     #          #              #           #                          #       #
#     #     #    #              #           #                          #       #
#     #     #    #              #           #                          ####    #
#     #     #    #        ##    #                                      #       #
#     #     #    #        #     ####################################   #       #
#     #     #             #     #                                      #       #
#     #     #             #     #                                      #       #
#     #     #             #     #                                      #       #
#     #     #             #     #                  #                   #       #
#     #     #    ####     #     ############    ## ######    ######### #       #
#     #     #    #        #     #                  #                   #       #
#     #     #    #        #     #                  #                   #       #
#     #     #    #        #     #                  #                   #       #
#     #     #    #                                                     #       #
#           #    #############################################    #### #       #
#########    ### #                                       #             #       #
#    #           #                                       #             #       #
#    #           #                                       #             #       #
#    #           #                                       #             #       #
#    #           #                                       #     #       #       #
#    #           ################    ####################      #       #       #
#    #    ###### #                    #                        #       #       #
#                #                                        ##    ###### #       #
#                #                                                     #       #
#                #                                       #             #       #
#                #                                       #                     #
#    #    #      #                    #                  #                     #
################################################################################
