80 80
################################################################################
#                              #     #    #     #       #              #       #
#                              #     #    #     #       #              #       #
#                              #     #    #     #       #              #       #
##################    ######## #          #     #       #      #       #       #
#      #                       #          #     #       #      #       #       #
#      #                       #          #     #       #      #       #       #
#                               ###    ## #     #       #      #       #       #
#                         #          #    #     #       #      #       #       #
#                         #          #    #     #       #      #       #       #
#                         #               #     #       #      #       #       #
#      #                       #          #     #       #      #       #       #
###    #   ################### #                #       #      ####    #       #
#      #     #                 ###              #       #      #       #       #
#      #                       #     #          #       #      #       #       #
#      #                       #     #          #       #   ## #       #       #
#      #                       #     #    #     #       #      #       #       #
#      #      ######    ###### #          #     #       #      #       #       #
#      #     #     #           ########    #### #       #      #       #       #
#      #     #                 #                #       #              #       #
#      #     #                 #                #       ########    ## #       #
#      #     #                 #                #       #    #    #    #       #
#      #     #                 #       #        #       #    #    #    #       #
#      #     #                 #       #        #       #    #    #    #       #
#                                               #       #    #         #       #
#################################    ########## #   ### #    #         #       #
#   #                  #       #      #         #       #    #         #       #
#   #                  #       #      #         #       #    #         #       #
#                      #       #      #         #       #    #    #    #       #
#                      #       #      #         #       #    #    #    #       #
#                      #       ###    #         #       #    #    #    #       #
#        ############# #       #      #*        #       #    #    #    #####   #
#   #        #         #    ## #      #         #       #    #    #    #       #
#   #        #         #       #       ###      #       #    #    #    #       #
#   #        #         #       #                #       #    #    #    #       #
#   #        #         #       #                #       #         #    #       #
#   #        #    #    #       #                #       #         #    #       #
#   #####    #    #    #       #                #                 #    #       #
#   #        #    #    #       ###########      #                 #    #       #
#   #        #    #    #       #      #    #    #            #    #    #       #
#   #        #    #    #       #      #    #    #            ##    ### #       #
#   #        #    #    #       #      #    #    #       #    #         #       #
#   #        #    #    #       #      #    #    #       #    #         #       #
#   #        #    #    #       #      #    #    #       #    #         #       #
#   #        #    #    #       #      #    #    #                      #       #
#   #        #    #    #       #      #    #    #########    ######### #       #
#   #        #    #    #       #      #    #    #           #    #     #       #
#   #        #    #    #       #      #    #    #           #    #     #       #
#   #        #    #    #       #      #    #    #           #    #     #       #
#   #        #    #    #       #      #         #           #    #     #       #
#   #             #    #              #         #           #    #     #       #
#   #             #    #        ###   #         ###    #### #    #     #       #
#   #             #    #              #         #     #     #          #       #
#   #             #    #              #   ##### #     #     #          #       #
#   #        #    #    #       #      #    #    #     #     #          #       #
#   #        #    #            #      #    #    #     #     #          #       #
#   #        #                 #      #    #    #     #     #    #     #       #
#   #        #   ######        #      #    #    #     #     #    #     #       #
#   #        #                 #           #    #     #     #    #     #       #
#   #        #         #       #                #     #     #    #     #       #
#   #        #         #       #                #     #     #    #     #       #
#   #        #         #       #                      #     #    #     #       #
#   #        #    #    #       #      #               #     #          #       #
#   #        #    #    #       #      #               #     ######    ##       #
#   #        #    #    #                              #     #    #             #
#   #        #    #    #    ################### #     #     #    #             #
#            #         #    #     #       #     ##    #     #    #             #
###########    ####### #          #       #     #     ##                       #
#                      #          #       #     #     #                #       #
#                      #          #       #     #     #                #       #
#                      #          #####   ###   #     #                #       #
#    #                 #    #     #             #           #    #     #       #
#    #         ##      #    #     #             #           #    #     #       #
#              #       #    #                   #                              #
#    ######### #       #    #                   ##    ##########################
#     #        #       #####    ## ###    ##### #         #                    #
#              #       #                        #                              #
#              #       #          #             #                              #
#              #       #          #             #                              #
################################################################################
