80 80
################################################################################
#    #                                                        #     #    #     #
#    #                                                        #     #    #     #
#    #                                #                       #     #    #     #
#     ####################    ####### ######    ############# #     #    #     #
#                                     #                #      #     #    #     #
#                                     #                #      #     #    #     #
#                                     #                       #     #    #     #
#    #                                #                       #     #    #     #
#    #                                                        #     #    #     #
#    ###########################################    ######### #     #    #     #
#    #     #      #                          #                #     #    #     #
#    #     #      #                          #                #     #    #     #
#    #            #                          #                #     #    #     #
#    #            #                          #                #     #    #     #
#    #            ############    ########## #                #     #    #     #
#    #            #               #          #                #     #    #     #
#    #     #      #               #           ############    #     #    #     #
#    #     #      #               #                #          #     #    #     #
#    ###    ##### #                                #          #     #    #     #
#    #    #       #                                           #          #     #
#    #    #       #                          #                #          #     #
#    #    #       #                          #                #          #     #
#    #    #       #                                           #          #     #
#    #    #       ######    ################################# #     #    #     #
#    #    #       #    #             #                        #     #    #     #
#    #    #       #    #             #                              #    #     #
#    #    #       #    #                                            #    #     #
#    #    #       #    #                                            #    #     #
#    #    #       #    #   ########## #######    #############      #    #     #
#    #    #       #    #                                      #     #          #
#    #    ####    #    #             #                        #     #          #
#    #    #       #    #             #                        #     #          #
#    #    #       #    #                                      #     #          #
#    #    #       #    ########################    ########## #     #    #     #
#    #            #    #                              #       #     #    #     #
#    #            #    #                              #       #     #    ###   #
#    #            #    #                              #       #     #*   #     #
#    #            #    #        #                     #       #     #    #     #
#    #    #       #    #        #                     #       #     #    #     #
#    #    #       #    #        #                     #       #     #    #     #
#    #    #       #    #        #                     #       #     #    #     #
#    #    #       #    #                              #       #     #    #     #
#    #    #       #    ##################    ######## #       #     #    #     #
#    #    #       #    #    #    #                    #       #     #    #     #
#    #    #       #    #    #    #                    #       #     #    #     #
#    #    #       #    #    #    #                    #       #     #    #     #
#    #    #       #    #    #    #                    #       #     #    #     #
#    #    #       #    #         #                    #   ### #     #    #     #
#    #    #       #    #         #                            #     #    #     #
#    #    #       #    #         ###############    ##        #     #    #     #
#    #    #             ######                                #     #    #     #
#    #    #                                                   #     #    #     #
#    #    #                                           #       #     #    #     #
#    #    #                                           #       #     #    #     #
#    #                                                              #    #     #
#    #####################    ##################################### #          #
#    #                                                      #       #   ########
#    #                                                      #       #     #    #
#    #                                                      #       #     #    #
#    #                                                      #       #     #    #
#    #################################    ################# ####    #     #    #
#    #                                                              #     #    #
#    #                                                              #     #    #
#    #                                                              #     #    #
#    #                                                              #     #    #
#                                                                   #     #    #
##########################################################    ##### #     #    #
#                                                             #     #     #    #
#                                                             #     #     #    #
#                                                             #     #          #
#                                                             #     #          #
###########################    ############################## #     #          #
#                                                                   #          #
#                                                                   #     #    #
#                                                              ##   #     #    #
#                                                                   #     #    #
#                                             #               #     #     #    #
#                                             #               #     #     #    #
################################################################################
