80 80
################################################################################
#              #      #        #    #    #     #         #                     #
#                     #             #    #               #                     #
#                     #             #                    #                     #
###    ##             #             #                    #                     #
#        ##########   #             #                     ################    ##
#        #            #        #    #          #                               #
#        #            #        #    #    #######    #####                      #
#        #            #        #    #    #                                     #
#                     #        #    #    #               #        #            #
###############    ## #        #    #    #               #        #            #
#          #    #     #        #         #                                     #
#          #    #     #        #         ##################################    #
#          #    #     #        #         #              #                 #    #
#          #    #     #        #         #                                     #
#    #     #    #     #        #         #                                     #
#    #     #    #     #        ###    ## #                                     #
#    #     #    #     #        #         #                     #               #
#    #     #    #     #        #         ########    ######### #   #############
#    #     #    #     #        #         #                     #               #
#    #     #    #     #        #    #    #                     #               #
#    #     #    #     #        #    #    #                     #               #
#    #     #    #     #        #                                               #
#    #          #     #        ############################    #################
#    #          #     #   #### #     #                                    #    #
#    #          #     #        #     #                                         #
#    #          #     #        #     #                                         #
#    #     #    #     #        #     #                                         #
#    #     #    #     #        #     #                                         #
#    #     #    #     #        #     ################################    #######
#    #     #    #     #        #             #                                 #
#    #     #    #     #        #             #                                 #
#    #     #    #     #        #                                               #
#    ###   #    #     #        #                                               #
#    #     #    #     #        #                                               #
#    #     #    #     #                                                        #
#    #     #    #     ######################################################   #
#    #     #    #     #    #    #     #          #    #      #                 #
#    #     #    #     #    #    #     #          #    #      #                 #
#    #     #    #     #    #    #     #          #    #      #                 #
#    #     #    #     #         #     #          #           #                 #
#    #     #    #     #         #                #           ##############    #
#    #     #    #     #                          #           #    #            #
#    #     #    #                                #                             #
#    #     #    #      #####                     #    #                        #
#    #     #    #          #     ##########      #    #                        #
#    #     #               #    #                ###    #####      ######    ###
#    #     #          #    #    #                #     #     #    #            #
#    #                #    #    #                #     #     #    #            #
#    ##    #####      #    #    #                #           #    #            #
#    #     #    #     #    #    ##    ### #      #           #    #      #     #
#    #     #    #     #    #    #    #    #      #           #    #      #     #
#    #     #    #     #         #    #    #      #                #            #
#    #     #    #     #         #    #    ###    ##############    #############
#    #     #    #     #         #         #      #     #     #       #         #
#    #     #    #     #         #         #      #     #     #       #         #
#    #     #    #     #    #    #         #      #     #     #                 #
#    #          #     #    #    #         #      #     #     #                 #
#    #          #     #    #    #    #    #      #     #     #             #   #
#    #          #     #    #    #    #    #      #     #     #             #   #
#    #          #     #    #    #    #    #      #     #     ####    #     #   #
#    #     #    #     #    #    #    #    #      #     #     #       #     #   #
#    #     #    #     #    #    #    #    #      #  *  #             ###    ####
#    #     #    #     #    #    #    #    #      #     #             #         #
#    #     #    #     #    #    #    #    #            #             #         #
#    #     #          #    #    #    #    #            #             #         #
#    ####    ######## #                                      #                 #
#    #          #     #####################    ##            ###############   #
#    #          #     #              #           #           #     #           #
#    #          #     #              #           #           #     #           #
#    #     #    #     #                          #     ###   #     #           #
#    #     #          #                          #     #     #     #     #     #
#    #     #          #        #          #      #     #     #     #     #     #
#    #                ##########          #      #     #     #     ######    ###
#    ##    #####      #              #           #           #     #           #
#    #          #     #              #######     #   ####### #     #           #
#    #          #     #              #           #           #                 #
#    #          #     #      #       #           #           #                 #
#    #          #     #      #       #           #           #          #      #
################################################################################
