80 80
################################################################################
#                  #                              #    #    #      #           #
#                  #                              #    #    #      #           #
#                  #                              #    #    #      #           #
###############    #            #                 #    #    #      ##          #
#     #            #            #                 #    #    #      #      #    #
#     #            #                              #    #    #      #      ###  #
#                  #####################    ##### #    #    #      #      #    #
#                                                 #    #    #      #      #    #
#                                                 #    #           #      #    #
#                                                 #    #           #      #    #
#                                                 #    #           #      #    #
#########################################    #### #    #           #      #    #
#     #       #                                   #    #    #      #      #    #
#     #       #                                   #    #    #      #      #    #
#             #                                   #    #    #      #      #    #
#             #                                   #    #    #    ##       #    #
#             #                                   #    #    #             #    #
#             #########    ###################### #    #    #       ###    #####
#             #           #                 #     #    #    #                  #
#             #           #                 #     #    #    #      #           #
########      #           #                 #     #    #    #      #           #
#    #        #           #                 #     #    #    #      #           #
#    #        #           ##    ########### #     #    #    #      #           #
#    #        ####    ### #                 #     #    #    #      #     #     #
#    #        #     #                             #    #    #      #     #     #
#             #     #                             #    #    #                  #
#             #     #                             #    #    ################   #
#             #     #      #################      #    #    #     #      #     #
#             #     #     #                            #    #     #      #     #
##   #              #     #                            #    #     #      #     #
#    #              #     #                            #    #     #      #     #
#    #                    #                                 #     #      #     #
#    #                    #       #               #         #     #      #     #
#    #        #           #       ###    ######## #         #     #      #     #
#    #        #           #       #               #         #     #   ## #     #
#    #        #     #     #       #               #    #    #     #      ##    #
#    #        #     #     ###     #               ######    #     #            #
#    #        #     ###   #       #               #    #    #     #            #
#    #        #     #     #       ##    #### #    #         #     #            #
#    #        #     #     #       #     #    #    #         #     #            #
#    ##    ## #     #     #       #     #    #    #         #     #      #     #
#    #        #     #     #       #     #    #    #         #     #      #     #
#    #        #     #     #       #          #    #    #    #     #      #     #
#    #        #     #     #       #          #    #    #    #     #      #     #
#                                                           #     #      #     #
#########################################    ############## #     #            #
#                                          #                #     #########    #
#                                          #                #            #     #
#                                          #                #            #     #
#                                          #           #    #            #     #
#                               #     #    #      #    #    #            #     #
#                               #     #    #      #    #    #     #      #     #
################    ########### ####    ## #      #    #    #     #      #    ##
#                               #     #    #      #####     #     #      #     #
#                               #     #    #      #         #     #      #     #
#                               #     #    #      #         #     #      #     #
#                               #     #    #      #         #     #      #     #
#           #          #        #     #    #      #         #     #      #     #
#           #          #        #     #    #      #         #     #      #     #
#                      #        #     #    #                #     #      #     #
##################     #        #          ###########      #     #      #     #
#   #                  #        #          #                #     #            #
#   #                  ##    ## #                           #     #            #
#                      #        #                           #     #            #
#                      #        #                           #     #            #
#    #########    #### #        #############    ########## #     #      #     #
#             #        #      * #                     #     #     #      #     #
#   #         #        #        #                     #     #     #      #     #
#   #         #        #        #                     #     #     #      #     #
#   #         #        #        #                     #     #     #      #     #
#   #####     #        #        #                     #     #     #      #     #
#   #         #        #        #    ################ #     #     ##     #     #
#   #          #####   #        #                     #     #     #      #     #
#   #                  #        #                     #     #     #      #     #
#   #    #             #        #                           #     #      #     #
#   #    #             #        #                           #     #      #     #
#   #    #    #        #        #                #          #     #      #     #
#   #    #    #        #        #                #          #     #      #     #
################################################################################
