80 80
################################################################################
#     #      #                      #       #                          #       #
#     #      #                      #       #                          #       #
#     #      #                      #       #                                  #
#     #      #########    ######### #       #                                  #
#     #      #    #                 #       #                                  #
#     #      #    #                 #       #                                  #
#     #      #    #                         #                                  #
#            #    #                         ####################    ############
#            #    #########    ##### ##     #      #      #    #               #
#            #    #      #                  #      #      #    #               #
#            #                      #       #      #      #    #               #
#     #      #                      #       #      #      #    #         #     #
#     #      #                      #       #      #      #    #         #     #
#     #      #                              #      #      #    #         #     #
#     #      ########    ################## #      #      #              #     #
#     #      #       #     #         #      #      #      #              #     #
#     #      #       #     #         #      #      #      #     ###      #     #
#     #      #       #     #         #      #      #      #              #     #
#     #      #       #     #         #      #      #      #    #         #     #
#     #      #       #     ####      #      #      #      #    #         #     #
#     #      #       #     #         #             #      #              #     #
#     #      #       #     #         ###           #      #######    ### #     #
#     #      #       #               #             #      #     #        #     #
#     #      #       #               #             #      #              #     #
#     #      #       #                      #      #      #              ##    #
#     #      #       #                      #      #      #              #     #
#     #      #       #     #                #      #      ###        ### #     #
#     #      #       #     #                #      #      #     #        #     #
#     #      #       #     #         #      #      #      #     #        #     #
#     #      #       #     #         #      #      #      #     #        #     #
#     #      #       #     #         #      #      #      #                    #
#     #      #       #     #         #      #      #      ###########    #######
#     #      #             #         #      #      #      #     #              #
#     #      #             #         #      #      #      #     #              #
#     #      #             #                #      #      #     #              #
#     #      #             #####    ####### #      #      #     #              #
#     #      #       #     #         #      #      #      #     ###    #########
#     #      #       #     #         #      #      #      #     #              #
#     #      #       #     #         #      #      #         *  #              #
#     #      #       #     #         #      #      #            #              #
#     #      #       #     ##    ### #      #      #                           #
#     #      #       #     #    #    #      #      #             ####   #####  #
#     #      #       #     #    #    #      #      #      #             #      #
#     #      #       #     #    #    #      #      #      #             #      #
#     ##     #       #     #    #    #      #      #      #     #       #      #
#     #      #       #     #    #    ####   #      #      #     #       #      #
#     #      #       #     #    #    #      #      #            #              #
#     #      #       #     #    #           #      ############    #############
#     #      #       #     #    #           #      #    #              #       #
#     #      #       #     #    #           #      #    #              #       #
#     #      ##      #     #    #           #      #    #                      #
#     #      #       #     #    #    #      #      #    #                      #
#     #      #       #     #    #    #      #      #    #     #                #
#     #      #       #     #    #    #      #      #    #     #                #
#     #      #       #     #    #    #      #      #          #                #
#            #       #     #    #    #      #      #          ##############   #
#   ######## #       ###   #    #    #      #      #          #       #    #   #
#       #    #       #     #         #      #      #          #       #    #   #
#       #    #       #     #         #      #      #    #     #       #    #   #
#            #       #     #         #      #      #    #     #       #    #   #
#            #       #     #         #      #      #    #     #       #    #   #
#            #       #     #    #    #      #      #    #     #       #        #
##    ##      #####    ### #    #    #      #      #    #     #       #        #
#       #                  #    #    #      #      #    #     #       #        #
#       #                  #    #    #      #      #    #     #       #        #
#       #                  #    #    #      #      #    #     #       ######   #
#       #    #    #        #    #    #      #      #    #     #    ## #    #   #
#       #    #    #        #    #    #      #      #          #       #    #   #
#                                           #      ########   #       #    #   #
####    ################################### #           #     #       #    #   #
#                                           #           #     #       #    #   #
#                                           #           #     #       #    #   #
#                                           #           #     #       #    #   #
#                                           #      #          #            #   #
###################    ######## ######      #      #          #            #   #
#                               #           #      #          #                #
#                               #           #      #          #                #
#                               #           #      #    #     #       #        #
################################################################################
