80 80
################################################################################
#    #       #                           #                #     #      #       #
#    #       #                           #                #     #      #       #
#    #       #                           #                #     #      #       #
#    #       #                           #   ############ #     #      #       #
#    #       #                           #           #    #     #      #       #
#    #       #############    ###########            #    #     #      #   #####
#    #       #                                            #            #       #
#    #       #                                            #            #       #
#    #       #                                            #            #       #
#    #       #                                            #            #       #
#    #    ## #                                            #     #      #       #
#    #       ###    ##################################### #     #      #       #
#    #       #      #        #       #           #        #     #      #       #
#    #       #               #       #           #        #     #      #       #
#    #       #               #       #                    #     #      #       #
#    #       #               #       #                    #     #      #       #
#    #       #               ##      #                    #     #      #       #
#    #       #      #        #       #    ############### #     #      #       #
#    #       ###    #        #       #           #        #     #      #       #
#    #       #      ######   #       #           #        #     #      #       #
#    #       #      #        #       #           #        #     #              #
#    #       #      #                            #              #              #
#    #       #      #                                           #              #
#    #       #      #                                           #              #
#    #       #      #                                           #      #       #
#    #       #      #        ###################    ##### #            #       #
#    #       #      #        #         #       #          #######      #       #
#    #       #      #        #         #       #          #            #       #
#    #       #      #        #                 #          #            #       #
#    #       #      #        #                            #            #       #
#    #       #               #                            #                    #
#    #       ########    ### #####    #########     ##### ####    ##############
#    #                       #                            #                    #
#    #                       #                 #          #                    #
#    #                       #                 #          #                    #
#    #                                                                         #
#    #       #########################################################    ######
#    #       #     #    #     #                              #                 #
#    #       #     #    #     #                                                #
#    #       #     #    #     #                                                #
#    #       #     #    #     #                                                #
#    #       #     #    #     #                                                #
#    #       #     #    #     #############    #################################
#    #       #     #    #    ##                                                #
#    #       #     #    #                                                      #
#            #     #    #                                                      #
#            #          #                                                      #
#            #          #                                                      #
#            #          #    ###################################################
#            #          #      #     #          #          #    #              #
##    ###### #     #    #      #     #          #          #    #              #
#      #     #     #    #      #     #          #          #                   #
#      #     #     #    #      #     #     #    #          #                   #
#      #     #     #    #      #     #     #    #     #    #                   #
#      #     ######            #     ###    ### #     #    #                   #
#      #     #     #           #          #     #     #    ##############    ###
#      #     #     #           #          #     #     #    #      #            #
#      #     #     #     ##    #                #     #    #      #            #
#      #     #     #    #                       #     #    #      #            #
###          #     #    #                       #     #    #      #     #      #
#            #     #    #       ###########     ####    ###       #     #      #
#            #     #    #              #        #     #                 ####   #
#            ###   #    #      #       #        #     #                 #      #
#      #     #     #    #      #       #        #     #                 #      #
#      #     #     #    #      #       #        #     #    ##           #      #
#      #     #     #    #      #       #        #     #    #      #            #
#      #     #     #    #      #                ###   #    #      #########    #
#      #     #     #    #      #                           #      #            #
#      #     #     #    #                                  #      #            #
#      #     #     #    ##########    ##########           #      #            #
#      #     #     #    #               #                                      #
#      #     #     #    #               #       #############    ###############
#      #     #     #    #                       #       #      *               #
#      #     #     #    #                       #       #                      #
#      #     #     #    ##    ########## ####   #       #                      #
#      #     #          #                       #       #                      #
#      #     #          #               #       #                              #
#      #     #          #               #       #                              #
################################################################################
