80 80
################################################################################
#       #                     #    #                             #        #    #
#                             #    #                             #        #    #
#                  #          #    #                             #        #    #
#                  #          #    #                             #             #
###############    #######    #                                  #             #
#                  #     #    #                                  #             #
#                  #          #     ##################    ####### ########    ##
#                  #          #                                                #
#     #            #          #    #                                           #
#     #            #          #    #                                           #
#                             #    #                                           #
#    #########################     ##########    ###############################
#      #    #    #     #           #    #      #       #        #    #    #    #
#      #    #    #     #           #    #      #       #        #    #    #    #
#                #     #           #    #      #       #        #    #    #    #
#                #     #      #    #    #      #       #        #    #    #    #
#                #     #      #    #    #      #       #        #    #    #    #
#                #     #      #    #    #      #       #        #    #    #    #
#      #    #    #     #      #    #    #      #       #        #    #    #    #
#      #    #### #     #      #    #    #      #       #        #    #    #    #
####   #    #    #            #    #    #      #    ## #        #    #    #    #
#      #    #    #            #    #    #      #       #             #    #    #
#      #    #    #      ###   #    #    #      #       #             #    #    #
#      #    #    #            #    #    #      #       #             #    #    #
#      #               #      #    #           #       #             #    #    #
#      #               #      #    #           #       #        #    #    #    #
#      #               #      #    #     ###   #       #        #    #    #    #
#      #               #      #    #           #       #        #    #    #    #
#      #         ###    ##### #    #    #      #       #        #    #    #    #
#                #       #    #    #    #      #       #        #    #    #    #
########    #### #       #    #    #           #       #        #    #    #    #
#          #     #       #    #    ######      #       #        #    #     ##  #
#          #     #       #    #    #           #       #        #    #         #
#          #     #       #    #    #           #       #        #    #         #
#    #     #     #       #    #    #           #       #        #    #         #
#    #     #     #       #    #    #           #       #        #    #    #    #
#    #     #     #       #    #    #    #      #                #    #    #    #
#    #     #     #       #    #    #    #      #                #    #    #    #
#    #     #     #       #    #    #    #      #                #    #    #    #
#    #     #     #       #    #    #    #      #                #    #    #    #
#    #     #     #       #    #    #    #      #       ######   #    #    #    #
#    ###   #     #       #    #    #    #      #       #        #    #    #    #
#    #     #     #       #    #    #    #      #       #        #    #    #    #
#    #           #       #    #    #    #      #       #        #    #    #    #
#    #           #       #    #    #    #              #        #    #         #
#    #           #       #    #    #    #              #        #    #######   #
#    #           #       #    #    #    #              #        #    #     #   #
#    #           #       #    #    #    #                       #    #     #   #
#    #           #       #    #    #    #      ####    ######## #    #     #   #
#    #    ###### #       #    #    #    #      #         #      #    #     #   #
#    #    #      #            #    #    ####   #         #      #    #     #   #
#    #    #      #            #    #    #      #         #      #    #     #   #
#    #    #      #            #    #    #      #                #    #     #   #
#    #    #      #            #    #    #      #                #    #     #   #
#    #    #      #       #    #    #                            #    #     #   #
#    #    #      #       #    #    #    ####################### #    #     #   #
#    #    #      #       #    #    #                            #          #   #
#    #    #      #       #    #    #                            #          #   #
#    #    #      #       #    #    #                            #          #   #
#    #    #      #       #    #    #                            #          #   #
#    #    ####   #       #    #    #                            #    #     #   #
#    #    #      #       #    #    #                                 #     #   #
#    #           #       #    #    ###################    ########## #         #
#    #           #       #    #    #        #     #             #    #         #
#    #           #       #    #    #              #             #    #         #
#    #           #       #    #    #              #             #    #         #
#    #    #      #    ## #    #    #              #             #    #     #   #
#    #    #      #       #    #    #               ###    ##### #    #     #   #
#    #    #      #       #    #    #                            #    ###   #   #
#    #    #      #       #    #    #                                 #     #   #
#    #    #      #       #    #    ####    #######                   #     #   #
#    #    #      #       #    #    #      #       #                  #     #   #
#                        #         #      #       #       #          #     #   #
#######################    ####### #      #       ####    ########## #     #   #
#                                  #      #       #                  #     #   #
#                                  #      #   *   #                  #     #   #
#                                  #              #                  #     #   #
#              #                   #              #                  #     #   #
################################################################################
