80 80
################################################################################
#          #     #           #                 #    #         #     #    #     #
#          #     #           #                 #    #         #     #    #     #
#          #                 #                 #    #         #          #     #
#######    #                 #                 #    #         #          #     #
#          #                 ###########    ## #    #    #    #          #     #
#          ######    ####### #      #          #    #    #    #######    #     #
#                  #         #      #          #    #    #    #     #    #     #
#    #             #         #      #               #    #    #     #    #     #
#    #                       #      #               #    #    #     #    #     #
#    #                       #      #               #    #    #     #    #     #
#    #                       ##     #######         #    #    ###   #    #     #
#                            #      #          #         #    #     #    #     #
###################    ##### #      #          #         #    #     #    #     #
#    #      #    #           #                 #         #    #     #          #
#    #           #           #                 #         #    #     #          #
#    #           #           #                      #####    ##     #          #
#    #           #           #########    ######### #               #          #
#    #                       #       #      #       #               #    #     #
#    #      #                #       #      #       #               #    #     #
#    ####   #                #              #       #    #          #    #     #
#    #      ######    ###### #              #       #    #    #          #     #
#    #      #                #              #       #    #    #          #     #
#    #      #                #              #       #    #    #          #     #
#    #      #                #####    ##### #       #    #    #          #     #
#    #      #                #        #     #       #                    #     #
#    #                       #        #     #       ##############    ## #     #
#    ################    ### #        #     #       #    #    #    #     #     #
#    #      #     #     #    #        #     #       #              #     #     #
#    #      #     #     #    #        #     #    ## #              #     #     #
#    #      #     #     #    #        #     #       #              #     #     #
#    #      #     #          #        #     #       #                    #     #
#    #      #     #          ######   #             #    #    #          #     #
#    #      #     ##         #        #             #    #    #          #     #
#    #      #     #          #        #             #    #    #          #     #
#    #      #     #     #    #        #             #    #    #    #     #     #
#    #      #     #     #    #        #     #       #    #    #    #     #     #
#    #      #     #     #    #        #     #       #    #         #     #     #
#    #      #     ######     #        #     #       #    ######    #     #     #
#    #      #     #    #     #              #       #    #         #     #     #
#    #      #     #    #     #              #       #    #         #     #     #
#    #      #     #    #     #              #       #    #         #     #     #
#    #      #     #          #              #       #    #         #     #     #
#    #      #     #          #        #     #       #    #    #          #     #
#    #      #     #          #        #     #       #    #    ########## #     #
#    #      #     #          #        #     #       #    #          #    #     #
#    #      #     #    #     #        #     #       #    #          #    #     #
#    #      #     #    #     #        #     #       #    #          #    #     #
#    #      #     #    #     #        #     #       #    #               #     #
#    #      #     #    #     #        #     #       #    #          *    #     #
#    #      #     #    #     #        ###   #       #                          #
#    #      #     #    ##    #        #     #       #########################  #
#    #      #     #    #     #        #     #       #           #              #
#           ##    #    #     #        #     #       #           #              #
#           #     #    #     #        #     #       #                          #
#           #          #     #        #     #       #                          #
#           #          #     #        #     #       #                          #
#    #      #          #     #                                                 #
#    #      #          #     ###################################    ############
#    #      #     #    #     #                          #     #        #       #
#    #      #     #    #     #                          #     #        #       #
#    #      #     #    #     #                          #              #       #
#    #            #    #     #                          #              #       #
#    #            #    #     #                                         #       #
#    #            #    #                                               #       #
#    #            #    #      ###    ###################               #       #
#    #      #     #    #                                 ###########   #       #
#    #      #     #    #                                #              #       #
#    #      #     #    #     #                          #              #       #
#    #      #     #    #     #                          #              #       #
#    #      #     #    #     #                                         #       #
#    #      #     #    #     ###    ###################################        #
#    #      #     #    #     #                 #                               #
#    #      #     #    #     #                 #                           #####
#    #      #                #                                                 #
#    #      ##    ########## #                                         #       #
#    #      #                #                                         #       #
#    #      #                #                                         #       #
#    #      #                #                 #                       #       #
################################################################################
