80 80
################################################################################
#       #    #           #                             #          #            #
#       #    #           #                             #          #            #
#       #    #           #                             #          #            #
#       #    #           #################    ######## #          #    #       #
#       #    #           #               #        #    #    #     #    #       #
#       #    #######     #               #             #    #     #    #####   #
#       #    #     #     #                             #    #     #    #       #
#       #    #     #     #                             #    #     #    #       #
#       #    #     #     ######    ######              #    #     #    #       #
#       #    #     #              #       ###    ##### #    #     #            #
#       #    ##    #              #      #                  #     ########    ##
#       #    #         ##         #      #                  #     #    #       #
#       #    #                    #      #                        #    #       #
#       #    #           #               #        #     #####     #    #       #
#       #    #           #               #        #    #    #     #    #       #
#       #    #                                         #    #     #    #####   #
#       #    ######################    ############### #    #          #       #
#       #    #                               #         #    #          #       #
#       #    #                                         #               #       #
#       #    #                                         #               #       #
#       #    #                                         #          #    #       #
#       #    #                                                    #    #       #
#       #    ################    ################################ #    #       #
#       #    #           #    #    #                              #    #       #
#   ### #    #           #    #    #                              #    #       #
#       #    #           #    #    #                              #    #       #
#       #    #     #     #    #    #                              #    #       #
#       #    #     #          #    #    #                         #    #       #
#       #    #     #          #    #    #                         #    #       #
#       #    #     ###        #    #    #                         #    #       #
#       #    #     #          #    #                              #    #       #
#       #    #     #     #         #   ########################## #    #       #
#       #    #     #     #         #        #              #      #    #       #
#       #    #           #         #        #              #      #    #       #
#       #    #    ###### #         #        #              #      #    #       #
#       #    #           #######   #                       #      #    #       #
#       #    #           #         #                       #      #    #       #
#       #    #           #         #                       #      #    #       #
#       #    #           #         #                       #      #    #       #
#       #    #                     #                              #    #       #
#       #    ###############    ## #                              #    #       #
#       #    #          #          #############    #######       #    #       #
#       #    #                     #     #    #                   #    #       #
#       #    #                     #                       #      #    #       #
#       #    #               #     #                       #      #    #       #
#       #    #               #     #               #       #      #    #       #
#            ###    ### #    #     #               #       #      #    #       #
#            #     #    #          #     #    #    #       #      #            #
#            #     #    #   ###### #     #    #            #      #            #
#            #     #    #     #    ####    ## ######    ## #      #            #
#       #    #     #    #     #    #     #    #            #      #            #
#       #    #     #    #     #    #     #    #            ####   #    #       #
#       #    #     #    #     #    #     #    #            #      #    #       #
#       #    #     #    #   ##           #    #     #      #      #    #       #
#       #    #     #    #                     #     #      #      #    #       #
#       #    #          #                     #     #      #      #    #       #
#       #    #          #                     #     #      #      #    #       #
#       #    #                                                                 #
#       #    ############    ###################################################
#       #                                              #                       #
#       #                                              #                       #
#       #                                              #                       #
#       #                                              #                       #
#       #    ###########################    ########## #   #####################
#       #    #                 #             #                        #        #
#       #    #                 #             #                                 #
#       #    #                 #             #                                 #
#       #    #                 #                                               #
#       #    #########    #### #                       #                   #   #
#       #    #                 #                       ###    ####### #    #   #
#            #                 #                       #              #    #   #
####    #### #                 #    ################## #              #    #   #
#     #      #      #          #                #      #              #    #   #
#     #      ##     #######   *#                #      #                   #   #
#     #      #      #          #                #      #    ############## #   #
#            #      #                           #      #                   #   #
#            #      #                                  #                   #   #
#            #      #                                  #                   #   #
################################################################################
