80 80
################################################################################
#               #      #           #                              #     #      #
#               #      #                                          #     #      #
#               #      #                                          #     #      #
##########      #      #                                          #     #      #
#    #          ####   ##############    ######################## #     #      #
#    #          #      #                                          #     #      #
#               #                                                 #     #      #
#                                                                 #     ##    ##
#         #                                                       #     #      #
#  ##     #                                                       #     #      #
#    ###    #### ########################    #################### #     #      #
#    #          #                                                 #     #      #
#    #          #                                                 #     #      #
#    #          #                                                 #            #
#                                                                 #            #
###########################    ################################## #            #
#     #       #      #       #            #     #      #          #            #
#             #      #       #            #     #                 #     #      #
#             #      #                    #     #                 ###   #      #
#             #                           #     #                 #     #      #
#             #                           #     #                 #     #      #
#     #       #                           #      #########    ### #     #      #
##    ####### #                           #            #          #     #      #
#   #    #    #      #                    #                       #     #      #
#   #    #    #      ###############      #                       #     #      #
#   #    #    #      #    #        #      #                       #     #      #
#   #    #    #      #    #               #                       #            #
#   #    #    #      #                    ############    ####### #########    #
#   #    #           #                         #                  #      #     #
#   #    #           #                         #                  #      #     #
#   #    #           #######    ## #           #                  #      #     #
#   #    #           #     #       ####        #                  #      #     #
#   #    #    #      #     #       #      #                       #      #     #
#   #    #    #      #             #      #                       #      #     #
#   #    #    #      #             #      #                       #      #     #
#   #    #    #      #                                            #      #     #
#   #    #    #   ## ######################################    ## #      #     #
#        #    #      #                      #    #       #        ##     #     #
#        #    #      #                      #    #       #        #      #     #
#        #    #      #                      #    #       #        #      #     #
#        #    #      #                 #    #    #       #        #      #     #
#   #    #    #      #                 #    #    #       #        #      #   ###
#   #    #    #      #                 #    #    #       #        #      #     #
#   #    #    #      #                 #    #    #       #        #      #     #
#   #    #    #      #                 #         #       #        #      #     #
#   #    #    #      #                           #       #        #      #     #
#   #    #    #      #######    ############     #       #        #      #     #
#   #    #    #      #      #                    #       #        #      #     #
##    ###     #      #      #               #    #       ####     #      #     #
#   #         #      #      #               #    #       #        #      #     #
#   #         #      #                      #    #       #        #      #     #
#             #      #                      #    #       #        #      #     #
#             #      #                           #   ### #        #      #     #
#                    ##    ##################### #       #        #      #     #
##########    ###### #        #            #     #       #        #      #     #
#            #       #        #            #     #       #        #      #     #
#            #       #        #            # *   #       #        #      #     #
#            #       #        #      #     #     #       #        #      #     #
#            #       #        #      #     #     #       #               #     #
#   #        #       #        #      #     #     #       #               #     #
#   #        #       #        #      #           #       #               #     #
#    ####### #   ### #        #                          #               #     #
#      #     #       #        ###    ######              #        #      #     #
#      #     #       #                                   #        #      #     #
#      #     #       #                     #             #        #      #     #
#      #     #       #                     #     #       #        #            #
#      #     #       #                           #       #        #            #
#      #     #       #        #   ############## #       #        #            #
#      #     #       #        #       #    #     #       #        #            #
#      #     #       #        #       #    #     #                #      #     #
#            #       #        #       #    #     #                #      #     #
#            #       #####    #            #     #                #      #     #
#   ###              #        #            #     #                #      #     #
#                    #        #            #     #                #      #     #
#      #             #        ####    #### #     #    ########### #      #     #
#      #             #        #            #     #                #      #     #
#      #     #       #        #                  #                #      #     #
#      #     #       #        #                  #                #      #     #
################################################################################
