80 80
################################################################################
#   #        #       #     #    #                   #    #       #    #        #
#   #        #       #     #    #                   #    #       #    #        #
#   #        #       #     #    #                   #    #       #    #        #
#   #        #       #     #    #                   #    #       #    #    #   #
#   #        #       #     #    #   ############### #    #       #    #    #   #
#   #        #       #     #    #    #    #         #    #       #    #    #   #
#   #        ###           #    #    #    #         #    #       #    #    #   #
#   #        #             #    #    #    #         #    #       #    #    #   #
#            #             #    #    #         #         #       #    #    #   #
#            #             #    #    #         #         #       #    #    #   #
#            #       #     #    #              #         #       #    #        #
#            #       #     #    #              #         #       #    ######   #
#   #        #       ##    #    #         #    #    #    #       #    #    #   #
#   #        #       #     #    #    #### #    #    #    #       #    #    #   #
#   #        #       #     #    #         ###    ## #    #       #    #    #   #
#   #####    #       #     #    #         #    #    #    #       #    #    #   #
#   #        #       #     #    #         #    #    #    #       #    #    #   #
#   #        #       #          #    #    #    #    #    #       #    #    #   #
#   #                #          #    #    #         #            #         #   #
#   #                #               #    #         #            #         #   #
#   #                #               #    #         #            #             #
#   #                #     #                        #            #             #
#   #        #       #     #     ################    ### #       #    #        #
#            #       #     #    #          #             #       #    #        #
#   ######## ########      #    #          #             #       #    #        #
#     #      #    #        #    #          #             #    ## #             #
#     #      #    #        #    #          #      *      #       #   ###########
#     #      #    #        #    #                        #       #    #    #   #
#     #      #    #        #    #                        #       #    #    #   #
#     #      #    #        #    #                        #            #    #   #
#     #      #    #        #    #                                     #    #   #
#     #      #    #        #    ######    #######################     #    #   #
#     #      #    #        #    #              #     #    #           #    #   #
#     #      #    #        #    #              #     #    #      #    #        #
#     #      #    #        #    #              #     #    #      #    #        #
#     #      #    #        #    #              #     #    #      #    #        #
#     #      #    #        #    #              #     #    #      #    #        #
#     #      #    #        #    ############   #          #      #    #    #   #
#     #      #    #        #    #        #     #          #      #    #    #   #
#     #      #    #        #    #        #     #          #      #    #    #   #
#     #      #    #        #    #        #     #          #      #    #    #   #
#     #      #    #        #    #        #     #          #      #    #    #   #
#     #      #    #        #    #        #     #    ##### #      #    #    #   #
#     #      #    #        #    #        #    ##    #     #      #    #    #   #
#            #    #        #    ######              #     #      #    #    #   #
#            #    #        #    #                         #      #         #   #
#            #    #        #    #                                #         #   #
#            #    #        #    #                                #         #   #
#     #      #    #        #    #                                #         #   #
#     #      #    #        #    #   ######################       #    #    #   #
#     #      #    #        #    #           #             #      #    #    #   #
#     #      #    #        #    #           #             #      #    #    #   #
#     #      #    #        #    #           #             #      #####     #   #
#     #      #    #        #    #           #             #      #    #    #   #
#     #      #    #        #    ##    ##### #####    #### #      #    #    #   #
#     #      #    #        #    #           #             #      #    #    #   #
#     #      #    #        #    #                         #      #    #    #   #
#     #      #    #        #    #                         #      #    #    #   #
#     #      #    ##    ## #                                     #    #    #   #
#     #      #    #        ###################################   #    #    #   #
#     #      #    #        #                                     #    #    #   #
#     #      #             #                                     #    #    #   #
#     ###    #             #                                     #    #    #   #
#     #      #             #                                     #    #    #   #
#     #      #                                                   #    #    #   #
#     #      #################    ############################## #    #    #   #
#     #      #                                  #                #    #    #   #
#     #      #                                  #                #    #    #   #
#     #      #                                                   #    #    #   #
#     #      #                                                   #    #    #   #
#                                                                #    #    #   #
##############    ############################################## #    #    #   #
#                         #                                      #    #    #   #
#                         #                                      #    #    #   #
#                         #                                      #    #    #   #
#                                                                #    #    #   #
#                                                                #         #   #
#                                                                #         #   #
################################################################################
