80 80
################################################################################
#    #          #       #       #     #            #    #     #                #
#    #                  #       #     #            #          #                #
#    #    #             #       #     #            #          #                #
#    #    #         ### #       #     ####    #### #          #                #
#    #    #             #       #             #    #          ###############  #
#    #    #     #       #       #             #    #          #     #     #    #
#    #    #     #       #       #                  ###    ### #           #    #
#    #    ##    #       #       #                  #     #    #           #    #
#    #    #     #       #       #     #            #     #    #           #    #
#         #     #       #       #     #            #     #    #           #    #
#         #     #       #       #     #       #    #     #     ##   #     #    #
#         #     #       #       #     #       #    #                #     #    #
###    ## #     #       #       #     #       #    #                #     #    #
#    #    ####    ##### #       #     #       #    #                #     #    #
#    #    #        #    #       #     #       #    #          #     #     #   ##
#    #    #        #    #       #     #       #    #     #    #     #     #    #
#    #    #        #    #       ##    ###     #    #     #    #     #          #
#    #    #        #    #       #     #       #    #     #    #     #          #
#    #    #        #    #       #     #       #    #     #    #     #          #
#    #    #        #    #       #     #       #    #     #    #     ##    ######
#    #    #        #    #       #     #       #    #     #    #     #     #    #
#    #    #        #    #       #     #            #     #    #     #     #    #
#    #    #        #    #       ######    ######## #     #    #     #     #    #
#    #    #        #    #       #    #      #      #     #    #     #     #    #
#    #    #        #    #       #    #      #      #     #    #     #     #    #
#    #    #        #    ####         #      #      #     #    #     #     #   ##
#    #    ##    ## #    #            #      #      #     #    #     #     #    #
#    #    #             #            #      #      #     #    #     #          #
#         #             #            ####   #      #     #    #     #          #
#         #             #       #    #      #      #                #          #
#         #             #       #           #      ###############    ##########
#         #        #            #           #      #      #      #    #    #   #
#    #    #        #            #           #      #      #      #         #   #
#    #    #        #            #           #      #      #      #         #   #
#    #    #        #            #    #      ##     #             #         #   #
#    #    #                     #    #      #      #             #         #   #
#    #    #   ################# #    #      #      #             #    #    #   #
#    #    #       #      #      #    #      #      ###           #    #    #   #
#    #    #              #      #    #      #      #      #      #####     #   #
#    #    #              #      #    #      #      #      ###    #    #    #   #
#    #    #              #      #    #      #      #      #      #    #    #   #
#    #    #              #      #    #      #      #      #      #    #    #   #
#    #    ########    ## #      #    #      #      #      #      #    #    #   #
#    #    #              #      #    #      #      #             #    #    #   #
#    #    #                     #    #      #      ########      #         #   #
#    #    #                     #    #      #      #    #        #         #   #
#                               #    #      #      #    #        #         #   #
####################    ####### #    #      #      #    #        #         #   #
#   #            #              #    #      #      #    #        #    #    #   #
#   #            #              #    #      #      #    #        #    #    #   #
#   #            #              #    #      #      #    #        #    #    #   #
#   #                           #    # *    #      #    #        #    #    #   #
#   #                           #    #      #      #    #        #    #    #   #
#   #                           #    #      #      #             #    #    #   #
#   #                           #    #             #             #    #    #   #
#   #####################    ## #    #             #             #    #    #   #
#   #     #                     #    #             #             #    #    #   #
#   #     #                     #    #             #    ###      #    #    #   #
#                               #           #      #    #        #    #    #   #
#                      #        ######      #      #    #        #    #    #   #
#                      #        #     #     #      #    #        #    #    #   #
#                      #        #     #     #      #    #        #    #    #   #
#   #                  #    ### #     #     #      #    #        #    #    #   #
#   #   ############## #        #           #      #    #        #    #    #   #
#   #                  #        #           #      #    #        #    #    #   #
#   #                  #        #           #      #    #        #    #    #   #
#   #                  #        #           #      #    #             #    #   #
#   #                  #        #           #      #    #             #    #   #
#                      #                           #    #             #    #   #
#####################    ######################### #    #             #    #   #
#                                  #                    #        #    #        #
#                                  #                    #        #    #        #
#                                  #                             #             #
#                                                   ##########    #########    #
#                                                  #                       #   #
#                                                  #                       #   #
#                                                  #                       #   #
#                                  #               #                       #   #
################################################################################
