80 80
################################################################################
#      #                     #     #    #         #        #    #    #    #    #
#      #                     #     #    #         #        #    #         #    #
#      #                     #     #         #    #        #    #              #
#      #                     #               #    #        #    #              #
#      #    ################ #                    #        #    #              #
#      #        #    #       #               #### #        #    #    #         #
#      #        #    #       #          #         #        #    #    #    #    #
#      #        #    #       #          #                  #    #    #    #    #
#      #        #    #       #          #                  #    #    #    #    #
#      #        #    #       #   ###### #                  #    #    #    #    #
#      #        #    #       #          #    #                  #    #    #    #
#      #        #    #       #          #    #    #                  #    #    #
#      #        #    #       #          #    #    #                  #    #    #
#      #             #       #          #    #    #                  #    #    #
#      #             #       #                    #        #         #    #    #
#      ######        #       #######    ######### #        #    #    #    #    #
#      #             #             #        #     #        #    #    #    #    #
#      #        #    #             #        #     #        #    #    #    #    #
#      #        #    #             #        #     #        #    #    #    #    #
#      #        #    #             #        #     #        #    #    #    #    #
#      #######    ## #       #     #        #     #        #    #    #    #    #
#           #        #       #     #        #     #        #    #    #    #    #
#           #        ####    #     ###    ##      #        #    #    #    #    #
#           #        #       #     #              #        #    #    #    #    #
#           #        #       #     #              #        #    #    #    #    #
#      #    #        #       #     #              #        #    #    ##    #####
#      #             #       #     #        #     #        #    #    #     #   #
#      #             #       #     #        #     #        #    #    #     #   #
#      #             #       #     #              #        #    #    #         #
#      #             #       #     ####    ###### #        #    #    #         #
#      #    #        #       #     #              ######   #    #    #         #
#      #    #        #       #     #              #        #    #    #         #
#      #    #        #       ###   #              #        #    #    #         #
#      #    #        #       #     #              #        #    ##    ##########
#      #    #        #       #     #              #        #    #    #     #   #
#      #    #        #       #     #     #        #        #    #    #     #   #
#      #    #        #       #     #     #        #        #    #    #     #   #
#      #    #   #### #       #     ##    #        #        #    #    #     #   #
#      #    #        #       #     #     #    ### #        #    #    #     #   #
#      #    #        #       #     #     #        #        #    #    #     #   #
#      #    #        #       #     #     #        #        #    #    #     #   #
#      #    #                #     #     #        #        #    #    #     #   #
#      #    #                #           #        #        #    #          #   #
#      #    #                #           #        #        #    #          #   #
#      #                                          #        #    #          #   #
#      #####################################      #        #    #          #   #
#      #                #               #    #    #        #    #    ###   #   #
#      #                #               #    #    #             #    #     #   #
#      #                #                    #    ##########    #    #     #   #
#      #                       #             #    #    #        #    #     #   #
#      #                       #             #    #    #        #    #     #   #
#      #                       #             #    #    #        #    #         #
#      ############    ####### #        #         #    #        #    #         #
#      #         #       #     #        #         #    #        #    #         #
#      #         #       #     #        #         #    ###      #    #         #
#      #         #             #        #         #    #        #    #     #   #
#      #         #             #        #    #    #    #        #    #     #   #
#      #         #             #        #    #    #    #        #    #     #   #
#      #         #             #        #    #    #    #        #    ####    ###
#      #         ####    ##### #        #    #    #             #    #         #
#      ####      #      #      #        #    #    #             #    #         #
#      #         #      #      ####     ###    ## #*            #    #         #
#      #         #      #      #        #         #             #    #         #
#      #         #      #      #        #         #    #        #    #         #
#      #         #      #      #        #         #    #        #    #         #
#      #         #      ##     #        #         #                  #         #
#      #         #      #      #        #         #################    #########
#      #             ## #      #                  #                            #
#   ## #                       ##    ############ #                            #
#      #                       #                  #                            #
#      #                       #                  #            #               #
#      #         #             #                  #     #      ###########    ##
#                #                                #     #      #               #
#################    ############################ ###    ##### #               #
#                                                 #            #               #
#                                                 #            #               #
#                                                 #            #         #     #
#                                                 #    #       #         #     #
################################################################################
