80 80
################################################################################
#   #           #                   #           #            #       #     #   #
#   #           #                   #           #            #       #     #   #
#   #           #                        #      #     #      #       #     #   #
#   #           #                        #      #     #      #       #     #   #
#   #    ###### #########    #######     #      #     #      #       #     #   #
#   #           #                        #      #     #      #    ## #     #   #
#   #                               ###    #### #     #      #             #   #
#   #                               #    #      #     #      #             #   #
#   #                               #    #            #      #             #   #
#   #####    ###################### #    #            #      #             #   #
#   #    #     #                    #    #            #      ########    ##    #
#   #    #     #                    #    #            #      #    #            #
#   #          #                    #           #     #      #                 #
#   #          #                    #           #     #                        #
#   #          #               #    #           #     #                    #   #
#   #          #               #    #########    #### #                    #   #
#   #    #     #                    #        #        #           #        #   #
#   #    #      ######    ######### #        #        #      #    #        #   #
#   #                      #        #        #        ##     #    #            #
#   #    ######            #        #        #        #      #####    ##########
#   #                               #                 #      #          #      #
#   #          #                    #                 #      #          #      #
#   #          #                    #                 #      #          #      #
#   #                                                 #      #          #      #
#   #############    ################################ #      #   ###### #      #
#   #                                     #    #      #      #          #      #
#   #                                     #    #      #      #          #      #
#   #                                     #    #      #      #          #      #
#   #                                     #    #      #      #    #     #      #
#   #########    ######################## #    #   ## #      #    #     #      #
#   #           #                         #    #      #      #    #     #      #
#   #           #                         #           #      #    #     #      #
#   #           #                                     #      #    #     #      #
#   #           #                                     #      #    #     #      #
#   #           #                             ####### #      #    #     #      #
#   ##    ###### ############    #########       #    #      #    #     #      #
#   #                      #      #       #      #    #      #    #     #      #
#   #                      #              #      #    #      #    #     #      #
#   #                                     #           #      #    #            #
#   #           #                         #           #      #    #            #
#   ###    #    #                         #           #      #    #            #
#   #      #    ####    ######### #    ## ####*       #      #    #            #
#   #      #    #                 #       #      #    #      #    #     #      #
#   #      #    #                 #       #      #    #      #    #     #      #
#   #      #    #                 #       #      #    #      #    #     #      #
#   #                                            #           #    #     #      #
#   ##########################################    ########## #    #     #      #
#   #      #                     #       #                   #    #     #      #
#   #      #                     #                           #    #     #      #
#   #      #                     #                           #    #     #      #
#   #                            #                           #    #     #      #
#   #                            #                           #    #     #      #
#   #                             ####################    ## #    #     ##    ##
#   #                                        #               #    #     #      #
#   #######    ##################            #               #    #     #      #
#   #           #                            #               #    #     #      #
#   #                            #                           #    #     #      #
#   #                            #                           #    #     #      #
#   #                            #                           #    #     #      #
#   #                                                                          #
#   ###################################    #####################################
#   #       #            #       #                                             #
#   #       #            #       #                                             #
#   #       #                    #                                             #
#   #       #                                                                  #
#   #       #                                                                  #
#   #       ###############    ## ###############    ###########################
#   #       #                                                                  #
#   #       #                    #                                             #
#   ####                         #                                             #
#   #                                                                          #
#   #        #####################################    ##########################
#   #                             #                                            #
#   #       #                     #                                            #
#   #       #                                                                  #
#   #       #                                                                  #
#           #                                                                  #
#           #                                                                  #
################################################################################
