80 80
################################################################################
#    #     #    #                            #      #        #      #    #     #
#    #     #    #                            #      #               #    #     #
#    #          #                            #      #               #          #
#    #          #                            #      #               #          #
#    #          #                            #      #               #          #
#    #    ##### #                            #      #########    ## #          #
#    #    #     #####################    ### #      #      #        #    #     #
#    #    #     #    #           #           #      #               #    #     #
#         #     #    #           #           #      #               #    #     #
#               #    #           #           #      #               #    #     #
#               #    #                       #      #               #    #     #
#               #    #                       #      #      #        #    #     #
#############        #                       #      #      #        #    #     #
#          #         #                       #      #      #        #    #     #
#          #         #                       #      #      #        #    #     #
#                    #                       #      #      #        #    #     #
#               #    ###############    #### #      #      #        #    #   ###
#    ######     #    #                  #    #      #      #        #    #     #
#    #          #    #                  #    #      #      #        #    #     #
#    #     #    #    #                  #    #      #      #        #    #     #
#    #     #    #    #                  #    #      #      #        #    #     #
#    #     #    #     ####    ######### #    #      #      #        #####    ###
#    #     #    #                            #      #      #   #### #          #
#          #    #                            #      #      #        #          #
#          #    #                            #      #      #                   #
#                                            #      #      #                   #
########################################     #      #      #             #     #
#                  #        #      #    #    ####   #      #             #     #
#                  #        #      #    #    #      #      #        #    ##    #
#                  #        #      #    #    #      #      #        #    #     #
#           #      #        #           #    #      #      #        #    #     #
#           #               #                #             #        #    #     #
#           #               #                #                                 #
#                      #### ####    ####     #          ########################
####    ###########         #                #           #      #          #   #
#                  #        #           #    #      #    #      #          #   #
#                  #        #           #    #      #    #      #              #
#                  #        #                #      #           #              #
#                  #        #####    ####### #      #           ###    ####    #
#                  #        #       #        #      #           #              #
#                           #       #        #      #           #          #   #
######################      #       #        #      #    #                 #   #
#     #               #     #       #               #    #            #    #   #
#     #               #     #       #               #    #       ##   #    #   #
#     #               #     #       #               #    #            #    #   #
#     #     #         #     #       #               #    #      #     #    #   #
#     #     #         #     #       #        #      #    ###    #     #    #   #
#     #     #         #     #       #        #      #    #      #              #
#     #               #     #       ######   #     *#    #      ############   #
#     ############    #     #       #        #      #    #      #     #        #
#     #        #      #     #       #        #      #    #      #     #        #
#     #        #      #     #       #        #      #    #      #              #
#     #        #      #             #        #      #           #              #
#     #        #      #             #        #      ######      #          #   #
#              #      #   ##        #        #      #           #          #####
#      ####    #      #      ###    #        #      #           #     #        #
#              #      #     #       #        #      #           #     #        #
#   ##              ##      #       #        #      #     #     #     #        #
#     #                     #       #        #      #     #     #     #        #
#     #                     #       #        #      #     #     #     #        #
#     #                     #       #        #                                 #
#                     #     #       #        #   ###############################
##############    ### #     #       #        #         #                       #
#   #    #            #     #       #        #         #                       #
#   #    #            #     #       #        #                                 #
#        #            #     #       #        #                         #       #
#        #            #     #       #        #                         #       #
#        #            #     #       #        ##    ################### #       #
####           ###### #     #       #        #     #                   #       #
#   #           #     #     #                #     #                   #       #
#   #           #     #     #                #     #                   #       #
#               #     #     #                #     #                   #       #
#        #      #     #     #                #     ####    ########### #    ####
#        #      #     #     #       #        #     #         #         #       #
#        #   ## ##    #     #       #        #               #         #       #
#   #    #            #     #       #        #                         #       #
#   #    #            #     #       #        #                         #       #
#   #    #            #     #       #        #                         #       #
################################################################################
