80 80
################################################################################
#   #     #                                              #       #     #       #
#   #     #                                              #       #     #       #
#   #     #                                   #          #       #             #
#   #     #                                   #          #       #             #
#   #     #                                   #          #       #             #
#   #     #                                              #       #             #
#         #############    ############################# #       #             #
#         #       #                                #     #       #             #
#         #       #                                #     #       #######    ####
#         #       #                                #     #       #      #      #
#   #     #       #                                #     #       #      #      #
#   #     #       #                                #     #       #      #      #
#         #       ###############    ############# #     #       #      #      #
#   ##### #       #                      #    #    ###   #       #   ## #      #
#   #     #       #                      #    #    #     #       #      #      #
#   #     #                              #               #       #      #      #
#   #                                    #               #       #      #      #
#   #                  #                                 #              #      #
#   #                  #                                 #              #      #
#                 #    #                  ######   #     #              #      #
#         #       ###    ################     #    #     #              ###    #
#         #       #                      #    #    #     #       #      #      #
#         #       #                      #         #     #       #      #      #
#   #     #       #                      #         #     #       #      #      #
#   #     #       #                      #         #     #       #      #      #
#   #     #       #                                      #       #      #      #
#   #     #       #######    ########################### #       #      #      #
#   #     #       #                            #         #       #      #      #
#   #     #       #                            #         #       #      #      #
#   #     #       #                            #         #       #      #      #
#   #     #       #                            #         #       #      #      #
#   #     #       #                             ######   #       #      #      #
#   #     #       #        #                             #       #      #      #
#   #     #       #        #                             #       #      #      #
#   #     #    ## #                                      #       #      #      #
#   #     #       #####################    ### #         #       #      #      #
#   #     #       #                            #    #    #       #      #      #
#   #     #       #                            #    #    #   ### #      #      #
#   #     #       #                            #    #    #       #      #      #
#                                                        #       #      #      #
################################################    #### #       #      #      #
#   #     #            #        #    #            #      #       #      #      #
#   #     #            #        #    #            #      #       #      #      #
#   #     #            #        #                        #       #      #      #
#   #     #                     #                        #       #             #
#   #     #                     #                        #       #             #
#    ##   #                     #     ######    ######## #       #             #
#         #########    ######## #    #    #      #       #       #             #
#         #        #      #     #    #    #      #       #       #      #      #
#         #        #      #     #    #    #      #       #       #      #      #
#   #     #        #      #     #    #    #      #       #              #      #
#   #              #      #     #    #    #      #       ##############    #####
#   #              #            #    #    #      #       #     #               #
#   #              #            #    #    #      #       #     #               #
#   #      ##      #            #    #    #              #     #               #
#   #     #        #####    ### #    #    #              #     #               #
#         #        #      #     #    #    ####       ### #     ###    ####     #
#######   #        #      #     #    #                   #     #     #    #   ##
#   #     #        #      #     #    #           #       #     #     #    #    #
#         #               #     #    #           #       #     #     #    #    #
#         #                     #    #                   #                #    #
#         #                     #    #    ########    ## #                #    #
#                               #    #    #              #                #    #
################    ########### #    #    #                               #    #
#    #     #                    #    #    #                    #          #    #
#    #     #                    #    #    #               ##   #          #    #
#    #     #                    #    #                         #########    ####
#    #     #                    ##    ################## #     #    #          #
##   #     #    ########    ### #           #            #     #    #          #
#          #    #               #           #            #     #    #          #
#          #    #               #           #            #     #               #
#          #    #                           #            #     #          #    #
#          #    #                #####      #######      #     #          #    #
#######     ####    ############     #                   #     #               #
#   #                  #                                 #     #    #########  #
#   #                  #        #                        #     #    #          #
#                               #                  #     #     #    #          #
#          #                    #           #      #     #     #    #        * #
################################################################################
