80 80
################################################################################
#   #                                    #                                     #
#   #                                    #                                     #
#   #                                    #                                     #
#   #                                                                          #
#   #                                                                          #
#   #                                                                          #
#   #####################################################    ###################
#   #            #     #         #          #                             #    #
#   #            #     #         #          #                                  #
#   #                  #         #          #                                  #
#   #                       #    #    #     #                                  #
#   #                       #    #    #     #                                  #
#   #####    ########## ####     #    #     #############    ############ #    #
#   #                            #          #                     #       ###  #
#   #                  #         #    ##### #                     #       #    #
#   #                  #         #    #     #                             #    #
#   #                            #    #     #                             #    #
#   ###############    ##########     #     #                             #    #
#   #     #     #       #             #     #                                  #
#   #     #     #       #             #     ###    #############################
#   #     #     #                     #     #                                  #
#   #     #     #                #    #     #                                  #
#   #     #                      #    #     #                                  #
#   #     #                      #          #                                  #
#   #     #             #        #          #   ## #####    ####################
#   #     #             #        #          #     #                     #      #
#   #     #     #       #        #          #     #                            #
#   #     #     #       #        #    #           #                            #
#   #     #     #       #        #    #           #                            #
#   #     #     #       #        #                                             #
#   #     #     #       #        ##################    #########################
#   #     #     #       #        #                      #    #    #      #     #
#   #     #     #       #        #                      #    #    #      #     #
#   #     #     #       #        #                      #    #    #      #     #
#   #     #     #       #        #                      #    #    #      #     #
#   #     #     #       #        ###    ############### #    #    #      #     #
#   #     #     #       ####     #          #      #    #    #    #      #    ##
#   #     #     #       #        #          #      #    #    #           #     #
#   #     #     #       #        #          #      #    #    #           #     #
#   #     #     #       #        #          #      #    #    #           #     #
#   #     #     #       #        #          #      #    #    #           #     #
#   #     #     #       #        ####    ## #           #    #    ####   #     #
#   #     #     #       #        #                      #    #    #            #
#   #     #     #       #        #                      #    #    #            #
#         #     #       #        #                      #    #    #            #
#         #     #       #        #                 #    #    #    #            #
#               #       #        ###        #   ## #    #    #    #      #     #
#               #       #        #     #    #      #    #    #    #      #     #
#   ###         #       #        #     #    #      #    #    #    #      #     #
#   #           #       #        #     #    #      #    #    #           #     #
#   #     #     #       #        #     #    #      #    #    ########    #     #
#   #     #     #       #        #                 #    #    #           #     #
#   #     #     #       #        ###############   #    #    #           #     #
#   #     ###   #       #        #       #         #    #    #           #     #
#   #     #     #       #        #       #         #    #    #           #     #
#   #     #     #       #        #  *              #    #     #########    #####
#   #     #     #       #        #                 #    #                      #
#   #     #     #       #        ###      ##    ## #    #                      #
#   #     #     #       #        #                 #    #                      #
#   #     #     ##      #        #       #         #         #                 #
#   #     #     #       #        #       #         #         #       #    ##   #
#   #     #     #       #        #                           ###     #     #   #
#   #     #     #       #        #    ###################### #       #     #   #
#   #     #     #       #        #      #           #        #       #     #   #
#   #           #       #        #      #           #        #       #     #   #
#   #######     #       #        #      #           #        #       ####    ###
#   #      #    #       #        #      #                    #       #     #   #
#   #      #    #       #        #      #                    #       #     #   #
#   #           #       #        #      #                    #       #     #   #
#   #           #       #        #      #                    #       #     #   #
#   #           #       #        ###    #                    #       #     #   #
#   #                   #        #       ###########    #### #       #     #   #
#   ###############     #        #            #              #       #     #   #
#   #            #      #        #            #              #       #   ##    #
#   #            #      #        #            #              #       #         #
#   #            #      #        #      #                    #       #         #
#   #                   #        #      #                    #       #         #
#   #                   #        #      #                    #       #     #   #
################################################################################
