80 80
################################################################################
#      #                #       #       #       #                 #       #    #
#      #                #       #       #       #                 #       #    #
#      #                #       #       #       #                 #       #    #
#  ### #                #       ####        ### #        #        #       #    #
#      #                #       #               ##    ## #        #       #    #
#      ###    ######### #       #               #        #        #       #    #
#      #         #              #               #        #        #       #    #
#                #              #               #        #        #       #    #
#                               #               #        #        #       #    #
#                                ###########    #        #        #       #    #
#                       #            #                   #        #       #    #
#                       #            #                   #        #       #    #
#                       #                                #        #       #    #
################    ### #       #                        #        #       #    #
#     #    #     #      #       #                        #        #       #    #
#     #    #     #      #       #####################    #        #       #    #
#     #    #     #      #       #    #     #    #        #                #    #
#     #    #     #      #       #          #    #        #                #    #
#     #    #     #      #       #          #    #        #                #    #
#     #    #     #   ## ##      #          #    #        #                #    #
#     #    #     #      #       #          #    #        #        #       #    #
#           ##   #      #       #          #    #        #        #       #    #
#                       #       #          #    #        #        #       #    #
#                       #       ########   #    #        #        #       #    #
###    ####             #       #     #         #        #        #       #    #
#    #     #            #       #     #         #        #        #       #    #
#    #     #     #      #       #     #         ####     #        #       #    #
#    #     #     #      #       #     #         #        #        #            #
#    #     #     #      #       #     #    #             #        #            #
#          #     #      #       #     #    #             #        #            #
#          #     #      #       #     #    #             #        #            #
#          #     #      #       #     #    #             #        #       #    #
#          ###    ##### #       ##    #    #    #        #        #       #    #
#    #     #            #       #     #    #    #        #        #       #    #
#    #     #            #       #     #    #    #        #        #       #    #
#    ###   #            #       #     #    #    #        #        #       #    #
#    #     #            #       #     #    #    #        #        #       #    #
#    #     #       #    #       #     #    #    #        #        #       #    #
#    #     #       #    #       #     #    #    #        ###      #       #    #
#                  #            #     #    #             #        #       #    #
###################    ######## #     #    #########     #        #       #    #
#              #                #     #    #    #        #        #       #    #
#                               #     #    #    #        #        #       #    #
#                               #     #    #    #        #        #       #    #
#                               #     #    #    #        #        ###     #    #
########    ### ##########      #     #    #    ####     #        #       #    #
#              #                #     #    #    #        #        #       #    #
#              #                #          #             #        #       #    #
#              #                #          #             #        #       #    #
#                                                        #        #       #    #
#   #################################################### #        #       #    #
#     #       #                #                 #       #                #    #
#     #       #                #                         #    ########### #    #
#             #                                          #      #         #    #
#             #    #                                     #      #         #    #
###       ### #    #                                     #      #         #    #
#             #    #                                     #      #         #    #
#     #       #                ######    ############### #      ##    ### #    #
#     #       #   ############ #                         #      #         #    #
#     #       #                #                         #                #    #
###    ###### #                #                         #                #    #
#    #        #                #                         #                #    #
#    #        #                                          ###############    ####
#    #        #########    ############################# #             #       #
#    #        #        #            #                    #             #*      #
#    #        #        #            #                    #             #       #
#    #        #        #                                 #             #       #
#    #####    #                                          ###    #######        #
#    #        #                                          #      #              #
##   #                                                   #                     #
#    #         #####                                     #                     #
#    #                 #   ############################# #             #####   #
#    #                 #                     #           #             #       #
#             #        #                     #           #      #      #       #
#             #        #                     #           ##     ####   #       #
#             #        #                                 #      #      #       #
#             #        #                                 #      #      #       #
#    #        #        #                                 #      #      #       #
################################################################################
