80 80
################################################################################
#     #             #                   #                        #        #    #
#     #             #                   #                        #        #    #
#     #       #     #                   #                        #        #    #
#     ###     #     ###########    #### #      ########    ##### #        #    #
#     #       #     #     #    #        #     #                  #        #    #
#     #       #     #     #    #        #     #                       ### #    #
#     #       ##    #     #    #        #     #                           #    #
#     #       #     #          #        #     #                           #    #
#             #     #          #        #     #                           #    #
#             #     #          #        #     #                           #    #
#             #     #          #        #     ################    ####### #    #
#      #######    ##           ######   #     #                           #    #
#     #      #       #######   #        #     #                           #    #
#     #      #            #    #              #                           #    #
#     #                   #    #              #    #    #                 #    #
#     #             #     #    #              #    #    #                 #    #
#     #             #                         #    #    #                 #    #
#     #             #                   #     #    #    #                 #    #
#     #                                 #     #    #                      #    #
#     #############################     ###   #    #######    ########### #    #
#  ## #                                 #     #    #      #    #          #    #
#     #                                 #     #    #      #               #    #
#     #                                 #     #    #      #               #    #
#     #                                 #     #    #      #               #    #
#                                       #     #    ###    #               #    #
#############    ###################### #     #    #      ############    #    #
#           #              #       #    #     #    #      #      #        #    #
#           #              #       #    #     #    #                      #    #
#                          #       #    #     #    #                  *   #    #
#                                       #     #    #                      #    #
#                                       #                                 #    #
########################                #############    ################ #    #
#                 #            ######## #                                 #    #
#                          #            #                                 #    #
#                          #            #                                 #    #
#                          #            #                                 #    #
#                          #            #                                 #    #
#                 #        #    #       #            #                    #    #
#                 #        #    #       #            #                    #    #
#                                                                         #    #
############################################################    ######### #    #
#                    #                           #             #    #     #    #
#                    #                           #             #    #     #   ##
#                    #                           #                  #     #    #
#                    #                           #                  #     #    #
#     #              #       #                   #                  #     #    #
#     #              #       #                   #                  #     #    #
#                    #                           ##########    #### #     #    #
###############      #######################     #      #           #     #    #
#        #           #    #              #       #      #           #     #    #
#                    #                   #       #                        #    #
#                    #                   #       #                        #    #
#                    #                   #       #                             #
#         ####    ## #     ##########    #       #################    ####     #
#        #      #    #    #              #       #      #        #             #
#        #      #    #    #              #              #        #             #
#        #      #         #              #              #        #        #    #
#        #      #                        #              #                 #    #
###      #      #     ###############        ####       #                 #    #
#        ####                                    #      #                 #    #
#        #           #                           #      #                 #    #
#        #           #                           #      #        #        #    #
#        #           #                           #      #        #        #    #
#                                                #      #        #        #    #
################    ############################ #      #    ### #        #    #
#                     #                          #   ## #        #        #    #
#                     #                          #      #        #        #    #
#                     #                          #      #        #        #    #
#                     #                          #               #        #    #
########    ######### #####################      #               #        #    #
#    #                #                #         #               #        #    #
#    #                                 #         ##########      #        #    #
#    #                                 #         #               ####     #    #
#    #                                 #         #               #        #    #
#     #########    ### ########    #### ####     #               #        #    #
#                     #                          #               #        #    #
#                     #                          #     #         #        #    #
#                     #                          #     #         #        #    #
################################################################################
