80 80
################################################################################
#                   #            #     #    #                   #     #        #
#                   #            #     #    #                   #     #        #
#          #        #            #     #    #                   #              #
#          #        #      #     #     #    ###    #########    #              #
#          #        #      #     #     #    #      #     #          ## #####   #
#          #        #      #     #     #           #     #                     #
#          #        #      #     #     #           #     #            #        #
########    ####### #####    ### #     #           #     #            #        #
#             #     #            #     #########   ###    ##    #     #        #
#             #                  #     #           #            ####    ########
#             #                  #     #           #            #       #      #
#                                ##    #           #            #       #      #
#                                #     #           #            #       #      #
#                                #     #########    ########### #              #
#########################    ### #     #                        #              #
#        #       #         #     #     #                        #              #
#                #         #     #     #                        #              #
#                #         #     #     #                                       #
#                #         #     #     #####################    ################
#                          #     #     #      #    #         #        #        #
#                          #     #            #    #         #        #        #
###    ########## ###      #     #            #    #         #        #        #
#                          #     #            #              #                 #
#                #         #     #            #              #                 #
#                #               #     #      #              #                 #
#                                #     #      ######    ##### ##########    ####
####    ###################      #     #      #                                #
#                 #              #     #      #                                #
#                 #        #     #     #      #                                #
#                 #        #     #     #      #              #         #       #
#                 #        #     #     #      #              #         #       #
###########    ## #        #     #     #      #                                #
#          #      #        #     #     #      #####################    #########
#          #      #        #     #     #      #     #        #         #       #
#          #      #        #     #     #      #     #        #         #       #
#          #      #        #     #     #      #     #        #         #       #
#     #           #        #     #     #      #     #        #         #       #
#     #           #        #     #     #      #     #        #    #    #       #
#     #           #        #     #     #      #     ######   ######    #       #
#     #        ###         #     #     #      #     #        #         #       #
######    ##               #           #      #     #        #         #       #
#     #    #               #           #      #     #                  #       #
#     #    #       ###     ###         #      #     #                  #       #
#          #      #        #           #      #     #                  #       #
#          #      #        #     #     #      #     #####    ######### ####    #
#          #      #        #     #     #      #                #       #       #
#          #      #        #     #     #      #                #       #       #
#                                      #      #                        #       #
##############    #################### #                               #       #
#           #    #        #    #       #            ####    ### ##     #       #
#           #    #        #            #            #                  #       #
#           #    #        #            #            #          #       #       #
#           #    #        #            #      #     #          #       #       #
#####    ## #    ####     #            #      #                        #       #
#    #      #    #        #            #      ##################    ## #       #
#    #           #        #########    ####   #   *   #    #    #      #       #
#    #           #                     #      #       #    #    #      #       #
#    #           #                     #      #       #    #    #      #       #
#     ###        #                     #      #       #    #    #      #       #
#           #    #                     #      #            #    #      #       #
#  ##       #    #######    ########## #      #                 #      #       #
#           #    #      #              #      #                 #      #       #
#    #      #    #      #              #      #   ####          #              #
#    #      #    #      #              #      #       #         #              #
#    #      #    #                #    #      #       #    #                   #
#    #      #    #                #    #      #       #    #                   #
#                #                #    #      #       #    #           #       #
##############   #                #    #      #       #####            #       #
#   #    #       #######    ##### #    #      #       #         ##     #       #
#   #    #       #      #         #    #      #       #         #      #       #
#        #       #      #         #    #      #       #         #      #       #
#        #                        #    #      #       #         #      #       #
#        #                        #    #      ########    ##### #      #       #
#        #                   #### #    #      #                 #      #       #
#####    ###      ##         #    #    #      #                 #      #       #
#                #      #         #    #      #                 #      #       #
#                #      #         #    #      #                 #      #       #
#                #      #         #    #      #    #            #      #       #
################################################################################
