80 80
################################################################################
#                           #       #      #            #           #          #
#                           #              #            #           #          #
#                           #              #                        #          #
#       #            #      #              #    #                   #          #
#       #            #      #   ####       #    #           ## #    ##    ######
#       #            #      #       #      #    #              #    #    #     #
#       #            #      #       #      #    #       #      #    #    #     #
#                    #      #       #      #    #       #      #    #    #     #
###    ############# #      #       #      #    #       #      #    #    #     #
#          #         #      #       #      #    #       #####    ## #    #     #
#          #         #      #       #      #    #       #           #    #   ###
#          #         #      #       #      #    #       #           #    #     #
#          #         #      #       #      #    #       #           #          #
#          #         #      #       #      #    #       #      #               #
#          #         #      #       #      #    #       #      #               #
#          #         #      #       #      #    #       #                      #
#          #         #      #       #      #    #       ########    ############
#          #         #      #       #      #    #       #    #     #    #      #
#          ####      #      #       #      #    #       #    #     #    #      #
#                    #      #       #   ## #    #       #    #     #    #      #
#                    #      #       #      #    #       #    #     #           #
#                    #      #       #      #    #       #    #     #           #
#                    #      #       #           #       #    #     #           #
####    ## #         #      #       #           #       #          #           #
#          #         #      #       #           #       #          ###    ######
#          #         #      #       #           #       #     ##   #    #      #
#          #         #              #      #    #       #          #    #      #
#                    #              #      #    #       #    #     #    #      #
###################    #####        #      #    #       #    #     #    #      #
#                                   #      #    #       #    #     #    #      #
#                           #       #      #    #       #    #     #    #      #
#                           #       #           #       #    #     #    #      #
#                           #       #    ###### #       #    #     #    #      #
#                      #    #       #    #      #       #    #     #    #      #
#                      #    #       #    #      #       #    #     #    #      #
#                      #    #       #    #      #       #    #     #    #      #
#                      #    #       #    #      #       #    #     #    #      #
#                                   #    #      #       #    #     #    #      #
#####    ########################## #    #   ## #       #    #     #    #      #
#   #     #    #         #          #    #      #       #    #     #           #
#         #    #         #          #    #      #       #    #     #           #
#         #    #         #          #    #      #       #    #     #           #
#              #         #          #    #      #       #    #     #           #
#              #                    #    #      #   ### #    #     #    #      #
#   #          #                    #    #      #       #    #     #    #      #
#   #          #                    #    #      #       #    #     #    #      #
#   #     #    #                    #           #       #    #     #    #      #
#   #     #    #                    #           #       #    #     #    #      #
#   #     #    #                    #           #       #    #     #    #      #
#   ###   #    ######    ########## #           #       #    #     #    #      #
#   #     #    #     #     #        #    #      #       #    #     #    #      #
#   #     #    #     #              #    #              #    #     #    #      #
#   #     #    #     #              #####    ########## #    #          #      #
#         #    #     #              #            #      #    #          #      #
#  ###### #    #     #              #            #      #    #          #      #
#         #    #     #     #        #            #      #    #          ###    #
#         #    #     #     #        #            #      #    #     #    #      #
#         #    #     #     #        #            #      #    #     #    #      #
#         #    #     #              ######    ## ###    #    #     #    #      #
#         #    #     ########    ## #            #      #    #     #    #      #
##########     #     #              #                   #    #     #    #      #
#   #          #                    #                   #    #     #    #      #
#   #                               #                   #    #     #    #      #
#                                   #                   #    #     #    #      #
#                                   #                   #          #    #      #
#                                                       #    ##### #    #      #
###################################################     #    #     #    #      #
#                                        #       #      #    #     #    #      #
#                                      *                #          #    #      #
#                                                       #          #    #      #
#                                                       #          #    #      #
#                                                       #          #    #      #
#                                                #      #    #     #    #      #
#                                                #      #    #     #    #      #
############    ################################ #      #    #     #    #      #
#                                                #      #    #     #    #      #
#                                                #      #    #     #    #      #
#                                                #      #    #     #    #      #
################################################################################
