80 80
################################################################################
#       #     #                                #     #    #         #      #   #
#       #     #                                #     #    #         #      #   #
#       #     #                                #     #    #    #    #      #   #
#       #     #                                #     #    #    #    #      #   #
#       #     #                  #             #     #    #    #    #      #   #
#       #     #                  #             #     #    #    #    #      #   #
#       #     #                                #     #    #    #    #          #
#       #     #########################    ### #     #    #    #    #          #
#       #     #    #     #               #     #     #    #    #    #          #
#       #     #    #     #               #     #     #    #    #    #          #
#       #     #    #                           #     #    #    #    #      #   #
#       #     #                                #    ##    #    #    #      #   #
#       #     #                                #          #    #    #      #   #
#             #                                #          #         ####    ####
#             #                          #     #          #   ##### #     #    #
#             #    ################      #     #          #         #     #    #
#             #    #                     #     #     #    #               #    #
#       #     #    #                     #     #     #    #               #    #
#       #     #    #                     #     #     #    #               #    #
#       ###   #    #                                 #    #    #          #    #
#       #     #    ##############    ##########      #         #    #     #    #
###     #     #    #                                 #         #    #     #    #
#       #          #                            #####          #    #     #    #
#       #          #                           #               #    #     #    #
#       #          #                           #          #    #  * #     #    #
#       #          #     #                     #          #    #    #     ##   #
#       #     #    #     #                     #          #    #    #     #    #
########      #    #     #######    ########## #                    #     #    #
#             #    #     #                     ###    ############# #     #    #
#             #    #     #                     #     #              #     #    #
#             #    #     #                     #     #              #     #    #
#                                              #                    #     #    #
##########################    ################ #                    #     #    #
#                                              #                    #     #    #
#                                              #                    #     #    #
#                                              #                    #     #    #
#                                              #                    #     #    #
#############################################    ################## #     #    #
#    #     #                     #                       #          #     #    #
#    #     #                     #                       #          #    ##    #
#          #                     #                                  #          #
#          #                     #                                  #          #
#          #         #           #                                  #          #
#          #         #           #                                  #          #
#    #     #         #           #                                  #     #    #
#    ###   ##########    ####### #                                  #     #    #
##   #     #       #             ##########    #################### #     #    #
#    #     #       #             #     #       #      #             #     #    #
#    #     #       #             #     #       #      #             #     #    #
#    #     #       #             #     #       #      #             #     #    #
#    #     #       #        #    #     #              #        #    #     #    #
###    ### #       #####    #    #     #              #        #    #     #    #
#          #       #        #    #     #####    ##             #    #     #    #
#          #       #        #    #     #                            #     #    #
#          #       #        #    #     #       #       ####    #### #     #    #
#    #     #   ### #             #     #       #                    #     #    #
#    #     #       #   ######### #     #              #             #     #    #
#    ##    #       #             #     ####    ###### #             #     #    #
#    #             #             #     #     #        #             #     #    #
#    #                           #     #     #        #             #     #    #
#    #                           #     #              #      #      #     #    #
#                                #     #              #      #      #     #    #
############    ################ #     #                            #     #    #
#     #        #                 #     #########    ############### #     #    #
#     #        #                 #     #            #               #     #    #
#              #                 #     #            #               #     #    #
#                       #        #     #            #               #     #    #
#                       #        ###   #            #               #     #    #
#                       #        #     ########    #####    ####### #     #    #
#     #                 #        #     #       #                    #     #    #
#     #        #        #              #       #                    #     #    #
#     #        #                       #       #                    #     #    #
####    ###### #####    #########      #                            #     #    #
#        #     #                       #            #        #      #     #    #
#        #     #                 #     ###          #    ### ##     #     #    #
#              #                 #                  #        #      #     #    #
#              #                 #             #    #        #      #     #    #
#              #      #          #             #    #        #      #     #    #
################################################################################
