80 80
################################################################################
#    #           #    #    #        #       #    #                        #    #
#    #           #    #    #        #       #    #                        #    #
#    #      #    #    #    #        #       #    #                 #      #    #
#    #      #    #    #    #        #       #    ############      #      #    #
#    #      #    #    #    #        #       #    #                 #      #    #
#    #      #    #    #    #        ##      #                      #      #    #
#    #      #    #    #    #        #       #                      #      #    #
#    #      #    #    #    #        #       #                      #      #    #
#    #      #    #    #    #        #       ########    ########## #      #    #
#           #    #    #    #####                    #         #    #      #    #
#           #    #    #    #                        #         #    #      #    #
#           #    #    #    #                        #         #    #           #
#           #    #    #    #                        #         #    #           #
#    #      #    #    #             #       #    ## #####     #    #           #
#    #      #    #    #             #       #       #    #    #    #           #
#    #      #    #    #             #       #            #    #    #      #    #
#    ###    #    #    #             #       #            #    #    #      #    #
#    #      #    #    #    #                #                 #    #      ##   #
#    #      #    #    #    #    ########### #                 #    #      #    #
#    #      #         #    #     #    #     #       #         #    #      #    #
#    #      #         #    #     #          #       #         #    #      #    #
#    #      #         #    #     #          #       #    #         #      #    #
#    #      #         #    #     #          #       #    #         #      #    #
#           #    #    #    #                #       #    #         #      #    #
########    #    #    #    #          #     #       #    #         #      #    #
#           #    #    #    #          #     #                 #    #      #    #
#           #    #    #    #          #     ###############   #    #      #    #
#           #    #    #    #   ###### #     #      #          #    #      #    #
#           #    #         #          #     #      #          #    #      #    #
#           #    #         #          #     #                 #    #      #    #
#                #         #          #     #                 #    #           #
##    ########## #         #                                       #    ########
#           #    #    #    #############    ###################### #    #      #
#           #    #    #    #               #                       #    #      #
#           #    #    #    #               #                       #    #      #
#                #    #    #               #                       #    #      #
#   #            #    #    #               #                       #    #      #
#   #####        #         #               #                       #    #      #
#   #            ######    ############    #####################   #    #      #
#   #       #    #         #                                       #    #      #
#   #       #    #         #                                       #    #      #
#   #            #         #                            *          #    #      #
#   #    ####### #                                                 #    #      #
#   #            #########################    #################### #    #      #
#   #            #                                                 #    #      #
#   #            #                                                 #    #      #
#   #            #                                                 #    #      #
#                                                                  #    #      #
##############################    ################################ #    #      #
#            #       #                             #         #     #    #      #
#            #       #                             #         #     #    #      #
#                    #                             #         #     #    #      #
#                                                  #         #     #    #      #
#                                                  ######    #     #    #      #
###    ############## ######################    ## #    #          #    #      #
#                                                  #    #          #    #      #
#                    #                             #               #    #      #
#                    #                             #               #    #      #
#                                                  #         ##    #    #      #
##################################    ############ #         #     #    #      #
#       #                 #      #     #           #    #    #     #    #      #
#       #                        #     #           #    #    #     #    #      #
#       #                        #                 #    #    #     #    #      #
#                                #                 #    #    #     #    #####  #
#                                #      ########   #    #    #     #    #      #
#                         #      #          #      #    #    #     #    #      #
#######################   ###    #     #    #      #    #    #     #    #      #
#                         #      #     #           #               #    #      #
#                         #      #     #           #############   #           #
#                         #      #     #           #       #       #           #
#                                #     #           #               #           #
##    ########################## #                 #               #           #
#          #                     ########    ##### #               #    #      #
#          #                          #            #    ### ####   #    #      #
#                                     #                    #       #    #      #
#                                     #                    #       #    #      #
#                                                          #       #    #      #
#                                #                         #       #    #      #
################################################################################
