80 80
################################################################################
#             #            #     #           #       #     #     #             #
#             #                  #           #       #     #     #             #
#   #         #                       #      #       #     #     #             #
#   #         #                       #      #       #     #     #    #        #
#             #                       #      #       #     #     #    #        #
#####    #### #                       #      #       #     #     #    #        #
#      #      #                  #    #      #       #     #     #    #        #
#      #      #####    ######### #    #      #       #     #     #    #        #
#      #      #        #    #    #    #      #       #     #     #    #        #
#      #      #        #    #    #    #      #       #     #     #    #        #
#      #      #             #    #    #      #       #     #     #    #        #
#   ## #      #             #    #    #      #       #     #     #    #        #
#             #             #    #    #      #       #     #     #    ####    ##
#             #                  #    #      #       #     #     #    #        #
#                      #         #    #      #       #     #     #    #        #
#                      #         #    #      #       #     #     #    #        #
#      ####            #         #    #      #       #     #     #    #        #
#      #       ######    ## #    #    #      #       #     #     #    #        #
#      #      #    #        #    ##    ##### #       #     #     #    #        #
#      #      #    #        #    #     #     #       #           #    #        #
#      #      #             #    #     #     #       #           #    #        #
#      #      #             #    #     #     #       #           #    #        #
#                                #     #     #       #           #    #        #
########    #################### #     #     #       #     #     #    #        #
#      #              #    #     #     #     #       #     #     #    #        #
#      #              #    #     #     #     #####   #     #     #    #        #
#      #              #    #     #     #     #       #     #     #             #
#      #      #       #          #     #     #       #     #     #    ##########
#      #      #       #          #     #     #       #     #     #     #       #
#      #      #       #          #     #             ####    ### #     #     * #
#      #      #       #          #     #             #      #    #             #
#      ###    #   ### #    #     #     #             #      #    #             #
#      #      #       #    #     ###   #             #      #    #             #
#      #      #       #    #     #           #       #      #    #             #
#      #      #       #    #     #           #       #      #    #     #       #
#      #              #    ##    #           #       #      #    #     #       #
#      ##    ######## #    #     #           #       #      #    #     #       #
#      #        #     #    #     #     #     #       #      #    #     #       #
#      #        #     #    #     #     #     #              #    #     #       #
#      #        #     #    #     #     #     #              #    #     #####   #
#      #        #     #    #     #                          #    #     #       #
#      #        #     #    #     ################           #    #     #       #
#      #        #     #    #     #     #        #    #      #    #     #       #
#      #   ##### ##   #    #     #     #        #    #      #    #     #       #
##     #              #    #     #     #        #    #      #    #     #       #
#      #              #    #     #     #        #    #      #    #     #       #
#      #              #    #     #     #        #    #      #    #     #       #
#      #        #     ##    #### #     #        #    #      #    #     #       #
#               #     #    #     ##    #        #    #      #    #     #       #
#               #     #    #     #     #        #    #      #          #       #
#               #     #    #     #     ######   #    #      #          #       #
#                     #    #     #     #        #    #      #          #       #
############    ##### #    #     #     #        #    #      #          #       #
#    #     #    #     #    #     #     #        #    ###    #    #     #       #
#    #     #    #     #    #     #     #             #           #     #       #
#    #     #    #     #    #     #     #             #           #     #       #
#    #     #    #     #    #     #     #             #           #     #       #
#    #     #    #     #    #     #                   #           #             #
#    #          #     #    #     #              #    #########    ##############
#    #           ##   #    ###   #              #    #        #        #       #
#    #                #    #     #              #    #        #        #       #
#    #                #    #     #     ######    ### #        #        #       #
#    ######           #    #     #     #             #        #        #       #
#    #          #     #    #     #     #             #        #                #
#    #          #     #    #     #     #             #        #                #
#    #          #     #    #     #     #             ##    ## #                #
#   ##     #    #     #    #     #     #             #         ######    #######
#          #    #     #    #     #     #####   #     #                         #
#          #    #          #     #     #       ##    #                         #
#     ##   #    #          #     #     #       #     #                         #
#          #    #          #     #     #       #     #        #                #
#    #     #    #          #     #     #       #     #        #    #           #
#    #     #    #     #    #     #                                 #           #
#    #          #     #          ###############################    ############
#    ###########      #          #           #                                 #
#    #                #          #           #                                 #
#    #                #          #                                             #
#    #                #    #     #                                             #
################################################################################
