80 80
################################################################################
#                 #                                                #      #    #
#                 #                                                #      #    #
#                 #    #                                           #      #    #
########    ######     #######    ################################ #      ##   #
#            #         #    #            #              #          #      #    #
#            #         #    #                           #          #      #    #
#                      #    #                           #          #           #
#                 #    #    #                           #          #           #
##    #######     #    #    #                           #    #     #           #
#                 #    #    #######################     #    #     ####    #####
#            #    #    #    #                      #    #          #      #    #
#            #    #    #    #                      #         ##### #      #    #
#            #    #    #                           #         #     #      #    #
#                 #    #                           #         #     #      #    #
################    ## #                           #               #      #    #
#       #    #         #     ################      #    #          #      #    #
#            #         #    #                           #          #      #    #
#                      #    #                           #          #      #    #
#                      #    #                           #    #     #      #    #
#             ######   #    #                           #    #     #      #    #
#       #              #    #                                      #      #    #
#       #    #         #    ##################################     #      #    #
#       #    #         #    #        #     #                       #      #    #
####    #              #    #        #     #                       #      #    #
#       #######    ### #    #        #     #                       #      #    #
#       #    #    #    #    #        #     #                       #      #    #
#       #         #    #    #         ##   ######    ############# #      #    #
#       #         #    #    #              #          #      #     #      #    #
#       #         #    #    #              #          #      #     #      #    #
#       #         #    #    #              #                 #     #      #    #
#       #         #    #    ####    ##     #                 #     #      #    #
#       #         #    #    #        #     #                       #      #    #
#       ######    #    #    #        #     #                       #      #    #
#       #    #    #    #    #        #     #############           #      #    #
#       #    #    #    #    #        #     #        #              #      #    #
#       #    #    #    #    #        #     #        #        #     #      #    #
#       #              #    #######    ####         #        #     #      #    #
#       #              #    #     #                          #     #      #    #
#       #              #    #                                #     #           #
#       #              #    #                                #     #           #
#       #    #    #    #    #              #                 #     #           #
#       #    #    #    #    #              #                 #     #           #
#                 #                                                #      #    #
###############    ############################################### #      #    #
#                     #       #                      #       #     #      #    #
#                     #       #                      #       #            #    #
#                     #       #                      #       #      ###   #    #
#                     #       #          #           #       #            #    #
#                                        #           #       #            #    #
#                                        #           #       #     #      #    #
##########    ########                               #       #     #      #    #
#        #                     ###########    ###### #       #     #      #    #
#        #            #       #         #            ####    #     #      #    #
#        #            #####   #         #            #       #     #      #    #
#                     #       #         #            #       #     #      #    #
#                     #       #         #            #       #     #      #    #
#                     #       ######    #   ######## #       #     #      #    #
#                             #    #            #    #       #     #      #    #
#    ######################## #    #            #    #       ##    #      #    #
#         #                   #                 #    #       #   * #      #    #
#         #                   #                      #       #     #      #    #
#                             #         #            #             #      #    #
#                             #         #            #             #      #    #
######     #########    ##### #    #    #            #             #      #    #
#                     #       #    #    #       #    #             #      #    #
#         #           #       #    #    #       #    #       #     #      ###  #
#         #           #       #    #    ####    #    #       #     #      #    #
#   #     #                   #    #    #       #    #       #     #      #    #
#   #     #                   #    #    #       #    #       #     #      #    #
#   #     #                   #    #    #       #    #       #     #      #    #
#                             #                      #       #     #      #    #
###########################    ##################### #####    #### #      #    #
#                                           #        #        #    #      #    #
#                                           #        #        #    #      #    #
#                                                             #    #      #    #
#                                                             #    #      #    #
#                                                                  #      #    #
#                                                                  #      #    #
################################################################################
