80 80
################################################################################
#      #           #    #       #                   #     #                    #
#      #           #    #       #                   #     #                    #
#      #           #            #                   #     #                    #
#      #           #            #                   #     #        #           #
#      #    #   ## #            ######    ######### #     #        #######    ##
#      #    #      #            #                   #     #        #      #    #
#      #    #      #            #                   #     #        #      #    #
#      #    #      #            #                         #        #      #    #
#      #    #      ######    ## #                         #        #      #    #
#      #           #     #      #             #           #        #      #    #
#      #########   #     #      #             #           ##    ## #      #    #
#      #     #     #     #      ##############    ####### #        #      #    #
#      #     #     #     #      #      #                  #        #      #    #
#      #     #     #      ###   #      #                  #        #      #    #
#            #     #            #      #                  #        #      #    #
#            #     #            #      #                  #        #      #    #
#            #     #            #      #     #            #        #      #    #
#            #     #     #      #      #     #            #        #      #    #
#      #     #     #     #      #      #                  #        #      #    #
#      #     #     ###   #      ###    ###############    #        #      #    #
#      #     #     #     #             #                  #        #      #    #
#      #     #     #     #             #                  #        #      #    #
#      #     #     #     #                                #        #      #    #
#      #           #     #                                #        #      #    #
#      #           #                                      #        #      #    #
#      ###         ####################################   #        #      #    #
#      #           #      #    #       #     #    #       #        #      #    #
#   ## #     #     #      #    #       #     #    #       #        #      #    #
#      #     #     #      #    #       #     #    #       #        #      ##   #
#      #     ##    #      #    #       #     #    #       #        #      #    #
#      #     #     ###         #       #                  #        #      #    #
#      #     #     #           #       #                  #        #      #    #
#      #     #     #           #       #                  #        #      #    #
#                  #                   #                  #        #      #    #
##    ############ #                   #     #    #       #        #           #
#        #         #    #######        #     #    #       #        #           #
#        #         #      #            #     #    ####    #        ####        #
#        #         #      #    #       #     #    #                #           #
#        #         #      #    #       #     #    #                #      #    #
#             #    #           #       #     #    #                #      #    #
#   #         #    #           #       #          #                #      #    #
#   #         #    #           #       #   ###### #       #        #      #    #
#   #         #    #           #       #          #       #        #      #    #
#   #    #    #    #      #    #       #          #       #        #      #    #
#   #    #    #    #      #    #       #          #       #        #      #    #
#   #    #    #    #      #    #####   #                  #        #      #    #
#   #         #    #      #    #        ###    ########## #        #      #    #
#   #    #### #    #      #    #                #         #        #      #    #
#   #    #    #    ##     #    #                          #        #           #
#   #    #    #    #      #    #                          #######    ###########
#   #    #    #    #      #    #       #                  #        #           #
#   #    #    #    #      #    #       #         ####     #        #           #
#   #    #    #    #           #       ##    ## #         #        #           #
#   #         #    ##########    ##### #        #         #                    #
#   #         #    #                   #        #         #                    #
#   #         #    #                   #        #         #                    #
#   #         #    #                   #        #         #                    #
#   #    #    #    #                   #        #         #                    #
#   #    #    #    #                                                           #
#   #    #    #    ###########################################    ##############
#   #    #    #    #    #     #       #                                        #
#   #    #    #    #    #     #       #                                        #
#   #    #    #    #    #     #             *                                  #
#   #    #    #    #    #     #                                                #
#   #    #    #    #    #     #        #########################    ############
#   #    #    #    #    #     ##    ##                                         #
#             #    #    #     #       #                                        #
#####    #### #    #    #     #       #                                        #
#             #    #          #       #                                        #
#             #    #          #                                                #
#             #    #          #################################    #############
#             #    #          #                    #                           #
##      #     #    #    #     #                                                #
#       #     #    #    ##### #                                                #
#       ##    #    #          #                                                #
#       #     #                                                                #
#       #     #                                    #                           #
#       #     #         #                          #                           #
################################################################################
