80 80
################################################################################
#     #           #                                        #    #       #      #
#     #           #                                        #            #      #
#     #           #                                        #            #      #
#           ##### #########################           #### #            #      #
#          #      #                             #          #            #      #
#  ###     #      #                             #          #    #       #      #
#                 #                             #          #    #       #      #
#     #           #                                        #    #####   #      #
#     #           #####################################    #    #       #      #
#                 #           #      #         #           #    #       #      #
##############    #                  #         #           #    #       #      #
#       #                            #         #           #    #       #      #
#       #                            #                          #       #      #
#       #                            #                          #       #      #
#       #          #############     #                          #       #      #
#       #    #    #       #          #                          #       #      #
#       #    #    #       #          #######    ########## #    #       #      #
#            #    #                  #               #     #####    ### #      #
#            #    #                                  #     #       #    #      #
#             ### #    ### ####    ##                #     #       #    ####   #
#####        #    #            #                     #     #       #    #      #
#       #    #    #       #    #                           #            #      #
#       #         #       #          #                     #            #      #
#       #         #       #          #                     #            #      #
#                                                          ##    ##     #      #
#################################    ##################### #       #           #
#       #      #      #       #         #           #      #       #           #
#       #      #      #       #         #           #      #       #           #
#       #      #      #       #         #           #      #       #           #
#       #      #      #       #         #    #      #      #       #           #
#       #      #      #       #         #    #      #      #       #           #
#       #      #      #       ###    ## #           #      #####    ############
#       #      #      #                 ########    #      #      #       #    #
#           ## #      #                 #      #    #      #      #       #    #
#              #      #     *           #      #    #      #      #       #    #
#              #      ###               #      #    #      #      #       #    #
#              #      #       #                #    #      #      #       #    #
#       #      #      #       #                #    #      #      #       #    #
#       #      #      #       #                #    #      #      #   ### #    #
#       #      #      #       #                #           #      #       #    #
#       #      #      #                 #      #           #      #       #    #
###     #      #      ####    ######### #      #     ##    #      #       #    #
#       #      #      #                 #      #           #      #       #    #
#       #             #                 #      #    #      #      #       #    #
#       #             #                 #      #    #      #      #       #    #
#       #             #           #     #      #    #      #      #       #    #
#       #             #     #     #     #      #    #      #      #       #    #
#       #      #      #     #     #     #      #    #      #      #       #    #
#       #      #      #     #     #     #      #    #      ##     #       #    #
#              #      #     #           #           #      #      #       #    #
#    ######### #      #     ##    ##### #           #      #      #            #
#         #    #      #     #     #     #           #      #      #            #
#         #    #      #     #     #     #           #      #      #            #
#         #    #      #     #     #     #      #    #      #      #            #
#         #    #      #     #     #     #      #    #      #      #       #    #
####    ##     #      #     #     #     #      #    #      #      #       #    #
#   #          #      #     #     #     #      #    #      #              #    #
#   #          ##     #     #     #     #           #      #              #    #
#   #          #      #     #     #     #########    ##### #              #    #
#   #     #    #      #     #     #     #    #        #    #              #    #
#   ###   #    #      #     #     #     #    #        #    ##    ######## #    #
#   #     #    #      #     #     #     #             #    #        #     #    #
#         #    #      #     #     #     #             #    #        #     #    #
#         #    #      #     #     #     #             #    #        #     #    #
#         #    #      #     #     #     #                  #        #     #    #
#         #           #     #     #     #    #             #        #     #    #
##########    ####### #     #     #     #    #             #        #     #    #
#        #    #       #     ##    #     #####    #####     #        #     #    #
#        #    #             #           #        #    #    #####    #     #    #
#             #             #           #        #    #    #              #    #
#                           #           #             #    #              #    #
#                           #           #             #    #              #    #
#   ##########        #                                    #              #    #
#     #               ##########################    ###### #        #     #    #
#             #####   #                       #            #        ###   #    #
#             #       #                       #            #        #     #    #
#             #       #                                    #        #     #    #
#             #       #                                    #        #     #    #
################################################################################
