80 80
################################################################################
#   #               #      #           #                                       #
#   #               #      #           #                                       #
#   #         #     #      #           #                                       #
#   #         #     #      ####    ### #                                       #
#   #         #     #      #      #    #                                       #
#   #         #            #      #    ###########################    ##########
#   #         #            #           #                     #                 #
#   #         ###          #                                                   #
#   #         #            #                                                   #
#   #         #     ###    #                                                   #
#   ####      #     #      #                                                   #
#   #         #     #      #############    ####################################
#   #         #     #      #       #    #      #    #    #    #     #          #
#   #         #     #      #       #    #      #    #         #     #          #
#   #         #     #      #       #    #      #    #         #     #          #
#   #         #     #      #       #    #           #         #     #          #
#   #######    #### #      #       #    #           #         #      ###    ####
#   #               #      #       #    #           #    #    #                #
#   #               #      #       #    #           #    #### #                #
#   #               #      #       #    #      #    #    #    #                #
#   #               #      #       #     ##    #### #    #    #                #
#   #      #        #      #       #                #         ####    ##########
#   #      #               #       #                #                          #
#   #####    ############# #       #                #                          #
#   #      #    #          #       #                #                          #
#   #      #    #          #       #                #                      #   #
#   #      #               #       #############    #                      #   #
#   #      #               #       #     #    #     #######################    #
#   #      #         ######        #     #    #     #       #      #       #   #
#   #      #         #             #     #    #     #       #      #       #   #
#   #      #    #    #             #     #    #     #       #      #       #   #
#   #      #    #    #             #     #    #     #              #       #   #
#   #      #    #    #     #       #          #     #              #       #   #
#   #      #    #    #     #       #          #     #              #       #   #
#   #      #    #    ##    #       #          #     #              #       #   #
#   #      #    #    #     #####   #          #     #              # *     #   #
#   #      #    #    #     #       #     #    #     #              #       #   #
#   #      #    #          #       #     #    #     #    ######### #       #   #
#          #    #          #       #     #    #     #     #        #       #   #
#    ###   #    #          #       ###   #    #     #     #        #       #   #
#          ###    ######## #       #     #    #     #     #        #       #   #
#          #      #        #       #     #    #     #     #                #   #
#   #      #               #       #     #    #     #     #                #   #
#   #      #               #       #     #    #     #     #                #   #
#   #      #               #       #     #    #     #     #                #   #
#   #      #               #       #     #    #     ###   #        #       #   #
#   #      #      #        #       #     #    #     #     #        #       #   #
#   #      #      #   #### #       ####    ## #     #     #        #       #   #
#   #      #      #        #       #     #    #     #     #        #       #   #
#   #      #      #        #             #    #     #     #        #       #   #
#   #             #        #             #    #     #     #        ####    #   #
#   #             #        #             #    #           #        #       #   #
#   #             #        #             #    #           #        #       #   #
#   #             #        #       #     #    #                    #       #   #
#   #      #      #        #       #     #    #                    #       #   #
#   #      #      #        #       #     #    #     #              #       #   #
#   #      #      #        #       #     #    #     #      ###     #       #   #
#   #      #      #        #       #     #    #     #     #        #       #   #
#   #      #      #        #       #     #    #     #     #        #           #
#   #      #   ## #        #       #          #     #     #        #           #
#   #      #      #        #       #          #     #     #        #           #
#   #      #      #        #       #          #     #     #                    #
#   #      #      #        #       #                ####    ############## #   #
#   #      #      #        #       #     #          #                #     #   #
#   #      #      #        #       #     #          #                #     #   #
#   #      #      #        #       #     #          #                #     #   #
#   #      #      #        #       #     #          #          #     #     #   #
#   #      #      #        #                        #          #     #     #   #
#   #      #      #        ###    ################# ######     ###   ##    #   #
#                          #                        #     #    #           #   #
#####################      #                        #     #    #           #   #
#       #                  #                        #     #    #           #   #
#       #                  #                        #          #           #   #
#       #                  ##########      #        #          ###    #### #   #
#       #                  #       #       ####     ###        #           #   #
#                          #               #        #          #           #   #
#                          #               #        #     #    #           #   #
#                          #               #        #     #    #           #   #
################################################################################
