80 80
################################################################################
#                                   #                         #          #     #
#                                   #                         #                #
#                                   #                         #                #
#################    ############## #####    ########## #     #                #
#   #                               #                   #     #                #
#                                   #                   #     #                #
#                                   #                   #     #                #
#                      #            #                         #####    #########
#         #            #            ################    ##### #      #    #    #
#   #     #############    ######## #                    #           #    #    #
#   #     #                         #                                #    #    #
##    ### #                         #                                #    #    #
#   #     #                         #               #                #    #    #
#   #     #                          ###    ####### #         #      #    #    #
#   #     #               #    #####                #    #    #      #    #    #
#   #     ###########     #                         #    #### #      #    #    #
#         #               #                         #         #      #    #    #
#         #               #         #               #         #      #    #    #
#         #               #         #               #         #      #    #    #
#                         #                                   #      #    #    #
#########################    ################################ #      #    #    #
#         #     #       #              #      #     #         #      #    #    #
#         #     #       #              #      #     #         #      #    #    #
#         #     #       #              #      #     #         #      #    #    #
#         #             #     #        #      #     #    #    ###    #    #    #
#    #    #             #     #        #      ##         #    #      #         #
#    #    #             #     #        #      #          #    #      #         #
#         #             #     #        #      #          #    #      #         #
#  ###### #             ###   ##    ###       #          #    #      #         #
#    #    ###    ###### #     #               #          #    #      #    #    #
#    #    #       #     #     #         ##    #   ###### #    #      #    #    #
#    #    #       #     #     #                     #    #    #      #    #    #
#    #    #       #     #     #        #            #    #    #      #    #   ##
#         #       #     #     #        #            #    #    #      #    #    #
#         #       ###   #     #        #                 #    #      #    #    #
#               ##      #     #        #      #          #    #      #    #    #
#                       #     #        #      #          #    #      #    #    #
#    #                   ###    ###### #      #   ##     #    #           #    #
#    #                                 #      #     #    #    #           #    #
#    #    #       #                    #      #     #    #    #                #
#    #    #       #                    #      #     #    #    #       #####    #
#    #    #       #     #              #      #          #    #      #    #    #
#    #    #       #     #         #    #      ########    ### #      #    #    #
#    #    #       #     #         #    #      #       #       #      #    #    #
#    #    #       #     #         #    #      #       #       #      #    #    #
#                 #     #                     #       #       #      #    #    #
################    ### ###################   #       #       #      #    #    #
#      #      #         #           #         #       #       #      #    #    #
#      #      #         #           #         ##      #       #      #    #    #
#      #      #         #           #         #       #       #      #    #    #
#      #      #    #    #           #         #       #       #      #    #    #
#      #      #    #    ######    ## ###      #       #   ### #      #    #    #
#      #      #         #                     #       #       #      #    #    #
#      #      #    #### #                     #               #      #    #    #
#      ####   #         #                     #               #      #    #    #
#      #      #         #                                     #      #    #    #
#      #      #         ############################    ##### #      #    #    #
#      #      #         #                              #      #      #    #    #
#      #      #    #    #                              #      #      #    #    #
#  ### #      #    #    #                              #      #      #    #    #
#      #      #    #    #                                     #      #    #    #
#      #      #    #    #                                     #      #    #    #
#      #      #    #    ############    ###############       #      #         #
#      #      #    #    #     #        #                      #      #         #
#      #      #    #    #              #               #      #      #         #
#             #    #    #              #               #      #  *   #         #
#             #    #    #              #               #      #      #    #    #
#             #    #    #                              #      #      #    #    #
#             #    #    #     #                        #      #      #    #    #
#             #    #    #     #                        #      #      #    #    #
#########          #    #     #                        #      #      #    #    #
#                  #    #     #                        #      #      #    #    #
#                  #    #     ####    ################ #      #      #    #    #
#                  #    #     #                        #      #      #    #    #
#             #    #    #     #                        #      #      #    #    #
#      #      #    #    #     #                        #      #      #    #    #
#      #      #    #    #     #                   #    #      #      #    #    #
#      #      #    #    #     #                   #    #      #      #    #    #
################################################################################
