80 80
################################################################################
#            #          #                   #                  #    #          #
#            #          #                   #                  #    #          #
#                       #        #          #                  #    #      #   #
#                       #        #          #    ############# #    #      #   #
#                       #        #     #    #     #     #      #    #      #   #
##########    ########## #####    #### #    #     #     #      #    #          #
#                #            #        #    #                  #    ###    #####
#                #            #        #    #                  #               #
#                                      #    #                                  #
#                       #              #    #      ##    ######                #
#                 ##    #                   #     #                            #
##    ###########       #######    ######## #     #                            #
#                #      #                   #     #            #   #############
#                #      #                   #     #      #     #               #
#                #      #                   #     #      #     #               #
#                                           #     #      #     #               #
###    #################################### #                                  #
#    #         #            #     #         ##############    ##################
#    #         #            #     #         #     #    #         #    #        #
#    #         #                  #         #     #    #         #    #        #
#    #         #                  #         #     #    #         #    #        #
#    ##    ### ##    ####### ##   #         #     #    #         #    #    #   #
#    #         #                  #         #     #    #         #    #    #   #
#    #                      #     #         #     #    ###    ## #    #    #   #
#                           #     #         #     #    #    #    #    #    #   #
#                           #     #         #     #    #    #    #    #    #   #
#         ################# #     #         #     #    #    #    #    #    #   #
#                 #         #     #         #     #    #    #    #    #    #   #
#    #            #         #     #         #     #    #    #    #    #    #   #
#    #            #         #     #         ###   #    #    #    #    #    #   #
#    #            #         #     #         #     #    #    #    #    #    #   #
#    #            #         #     #         #          #    #    #    #    #   #
#    #                      #     #         #          #    #    #    #    #   #
#    #                      #     #         #          #    #    #    #    #   #
#    #                            #         #          #    #    #    #    #   #
#    #   ######################## #         #     #    #    #    #    #    #   #
#    #          #     #     #     #               #    #    #    #    #    #   #
#    #          #     #     #     #               #    #    #    #    #    #   #
#    #          #     #     #     #               #    #    #         #    #   #
#    #          #     #     #     #               #    #    #         #    #   #
#    ########   ###   #     #     #         #     #    #    #         #    #   #
#    #     #    #     #     #     #         #     #    #    #         #    #   #
#    #          #     #     #     #         #     #    #    #    #    #    #   #
#    #                #           #         #     #    #    #    #    ###    ###
#    #                #           #         #     #    #    #    #    #    #   #
#    #                #           #         #          #    #    #    #    #   #
#    ########    #### #           #         ##    #### #    #    #    #    #   #
#    #                #                     #     #    #    #    #         #   #
#    #                ####    ####          #     #    #         #         #   #
#    #                #                     #     #    #         #         #   #
#    #                #                     #     #    #         #         #   #
#    ######    ##     #           #         #     #    #         #    #        #
#    #          #                 #         #     #    #    #    #    #        #
#    #          #            #    #         #     #    #    #    #    #        #
#    #          #            #    #         #     #    #    #    #    #        #
#                                 #         #     #    #    #    #    #        #
##############################    #         #     #    #    #    #             #
#       #       #                 #         #    *#    #    #    ######    #####
#       #                         #         #     #    #    #    #         #   #
#       #                         #         #     #    #    #    #             #
#       #                         #         #     #    #    #    #             #
#       #                         #         #     #    #    #    #             #
#       #       #                 #         #     #         #    #    #        #
#  #### #       #                 ####      #     #         #    #    #####    #
#       #                         #         #               #    #    #    #   #
#       #######################   #         #               #    #    #    #   #
#       #        #         #      #         #          #    #    #    #        #
#                #         #      #         #          #    #    #    #        #
#                          #      #         #     #    #    #    #    #        #
#                          #      #         #     #    #    #                  #
#                                 #         #     #    ##    ###################
#       #                         #         #     #    #    #                  #
#       #                         #         #     #    #    #                  #
#       #                         #         #     #    #    #                  #
#       ##    ############ #      #         #     #    #    #                  #
#       #                  #      #         #     #    #                       #
#       #                  #      #         #     #    #                       #
#       #                  #      #         #     #    #                       #
################################################################################
