80 80
################################################################################
#    #    #     #       #       #    #     #               #      #        #   #
#    #    #     #               #    #     #               #      #        #   #
#    #    #     #                    #     #               #      #        #   #
#    #    ###   #                    #     #               #      #        #   #
#    #    #     ###                  #     #   ## #        #      #        #   #
#    #    #     #       ##########   #     #      #        #      #        #   #
#    #    #             #            #     #      #        #      #        #   #
#    #                  #            #     #      #        #      #        #   #
#    #                  #            #     #      #               #        #   #
#    #                  #            #     #      #               #        #   #
#    #          #       #            #     #      #   #####       #        #   #
#    #####      #                    #     #      #               #        #   #
#    #          ##########    ###### #     #      #        #      #        #   #
#    #          #      #        #    #     #      #        #      #        #   #
#  ##           #      #        #    #     #      #        #      #####    #   #
#               #      #        #    #     #      #        #               #   #
#               #      #        #    #     #      #        #               #   #
#               #      #    ### #    #     #      #        #               #   #
#               #               #    #     #      #        #               #   #
#####    ###### #               #    #     #      #        #      #            #
#      #        #               #    #     #      #        #      #            #
#      #        #               #    #     #      #               #            #
#      #        #      #        #    #     #      ###    ######## #            #
#      #        #      #        #    #     #      #        #      #        #   #
#      #        #      #        #    #     #      #               #        #   #
#      #        #      #        #    #     #      #               #        #   #
#      #        #      #        #          #      #               #            #
#      #        #      #        #          #      #####     ###   ####    ######
#      #        #      #        #          #      #        #      #            #
#      #        #      #        #          #      #        #      #            #
#               #      #        #    #     #      #        #      #            #
#               #      #        #    #     #      #                            #
#               #      #             #     #      #######################    ###
#               #      #             #     #      #       #       #     #      #
#      ####     #      #             #     #      #       #       #     #      #
#      #        ####   ######    ### #     #      #       #       #     #      #
#      #        #      #             #     #      #               #     #      #
#      #        #      #             #     #      #               #     #      #
#      #        #      #             #     #      #               #    ###    ##
#      #        #      #             #     #      ####    ####### #            #
#      #        #      #                   #      #       #       #            #
#      #        ####    ###################       #               #            #
#      #        #        #     #     #            #               #            #
#      #        #              #     #            #               ##    ########
#      #        #                    #            ##    ## ##                  #
#      #        #                          #      #       #                    #
#      #        #                          #      #       #                    #
#      #        #        #   ########      #      #       #                    #
####   #        #        #     #           #                      #            #
#      #        #        #     #     #     ###################    ##############
#      #        #        #           #     #         #     #         #         #
#      #        #        #           #     #               #         #         #
#      #        #        #           #     #               #         #         #
#      #        #        #########    #### #               #         #    #    #
#      #        #    ### #            #    #               #    #    #    #    #
#      #        #        #                 ###    ## #     #    #    #    #    #
#      #        #        #                 #         #     #    #    #    #   ##
#      #        #        #                 #         ##    #    #    #    #    #
#                                          #         #     #    #    #    #    #
#############################    ######### #         #     #####     #    #    #
#     #       #               #       #    #         #     #         #         #
#     #                       #            #               #         #######   #
#     #                       #        *   ############              #         #
#     #                       #            #          #                        #
#     #                       #            #          #         #              #
#     #                       #    ####### #          #         #              #
#     ###########    #########             #          #    #                   #
#     #                                    #    #     #    #######    ##########
#     #                                    #    #     #    #              #    #
#     #                                    #    #     #    #              #    #
#     #                                    #####      #    #              #    #
##    ##################################   #    #     #    #              #    #
#     #                  #                 #    #     #    #              #    #
#     #                  #                 #    #     #    ######    #### #    #
#     #                  #                 #    #          #              #    #
#     #                  #                 #               #                   #
#                                          #               #                   #
#                                          #               #                   #
################################################################################
