80 80
################################################################################
#      #              #    #    #                 #              #       #     #
#      #              #    #    #                                #       #     #
#               #     #    #    #                                #             #
#               ###             #####    ######### ####    ##### #             #
#               #               #                                #   ####      #
#               #               #                 #              #             #
#      #    ### #               #                 #              #       #     #
#      #        #     #    #    #                 #              #       #    ##
#      #        #######    #    ################    ############ #       #     #
#      #        #     #    #    #    #    #    #     #      #    #       #     #
#   ## #        #          #    #    #    #    #                 #       #     #
#      #        #          #    #         #    #                 #       #     #
#      #        #          #    #         #    #                 ######    #####
#      #        #          #    #         #    ##                #     #       #
#      #        #     #    #    #         #    #     #      #          #       #
#               ##    #    #    #    #    #          #   ## #          #       #
########    ### #     #    #    #    #    #          #      #          #       #
#               #     #    #    #    #    #          #      #          #       #
#               #     #    #    #    #    #          #      #    #     #       #
#               #     #    #    #    #    #   ###### #      #    #     #       #
#               #          #    #         #     #    #      #    #     #       #
##############    ######## #    #    #### #     #    #      #    #     #       #
#     #     #     #        #    #    #    #     #    #####    ## #     #       #
#     #     #     #        #    #    #    #     #    #           #     #       #
#     #     #     #        #    #    #    #     #    #           #     #       #
#     #     #     #        #    #    #    #     #    #           #             #
#     #   ##      #        #    #    #    #     #    #           #             #
#     #                    #    #    #    #     #    ##    ##    #             #
#     #                    #    #    #    #     #    #      #    #             #
#     #                    #    #    #    #          #      #    #     #       #
#     #     #           ## #    #    #    #          #      #    ##    #       #
#     #     #     #        #    #    #    #          #      #    #     #       #
#     #     #     #        #    #    #    #                      #     #       #
#      ##    #### #        #    #    #    ##############    #### #     ####    #
#                 #        #    #    #    #      #               #     #       #
#                 #        #    #    #           #               #     #       #
#                 #        #    #    #           #               #     #       #
#     #                    #    #    #           #               #     #       #
#     #    ############### #         #          ############     #     #       #
#     #             #      #         #    #               #      #     #       #
##    #                    #         #    #               #      #     #       #
#     #                    #         #    #               #      #     #       #
#     #                    #    #         #               #      #     #       #
#     ##########        ## #    #         #      #               #     #       #
#     #             #      #    #         #      #               #     #       #
#     #             #      #    #         #      #               #     #       #
#     #             #      #    #                                              #
#     #             #      #    ############    ################################
#                   #           #          #    #                          #   #
####################    ####### #               #                              #
#       #        #      #       #               #                              #
#       #               #       #               #         #                    #
#       #               #       #     #         ####      #                    #
#       #               #       ##    #    #    #         #                    #
#       #               #       #     #    #              #########    #########
#       #####    #      #       #     #    #              #    #               #
#   ### #        #      #       #     #    #              #    #               #
#       #        #      #    ## #          ##########     #                    #
#       #        #              #    ##### #              #                    #
#       #        #              #          #              #             #      #
#       #                       #          #              #             #      #
#       ###########             #          #              #    ###      #    ###
#       #        #      #       #                    #    #    #        #      #
#                       #       #################    #### #    #        #      #
#                       #       #               #         #    #        #      #
#                       #       #               #         #    #               #
#                       #       #               #         #    ###    ##########
#                       #       #          #    #         #    #               #
#                       #       #          #    #         #    #               #
#  #################### #       #               #         #    #               #
#       #               #       ######    ##### #         #    #          #    #
#       #               #       #    #          #         #    #          #    #
#                       #       #    #          ####      #    #    #     #    #
#                       #       #             * #         #    #    #          #
#  ##### #######    ### #       #                         #    #    #########  #
#                       #       #                         #    #    #          #
#       #               #       #                         #    #    #          #
#       #               #       #    #                    #    #    #          #
################################################################################
