80 80
################################################################################
#       #                  #               #                    #    #         #
#       #                  #               #                    #    #         #
#       #                  #               #         #          #              #
#       #                  #               #         #          #              #
#       #                  #               #         #          #              #
#       #                  ##    ######### #         #          #########    ###
#       #######    ####### #    #    #     #                    #        #     #
#       #     #            #    #    #     ###############      #        #     #
#       #     #            #    #    #     #                                   #
#       #     #            #    #    #     #                                   #
#       #     #            #    #    #     #                                   #
#####         #      #     #    #    #     #                        #####      #
#             ####   ###   #    #    #     #######    ## #      #        #    ##
#             #      #     #    #    #     #             #      #        #     #
#             #      #     #    #    #     #             #      #        #     #
#       #            #     #    #    #     #             #      #        #     #
#       #            #     #    #    #     #             #      #        #     #
#       #            #     #    #    #     #                                   #
#       #      ####    ### #         #     #    ################################
#       #     #    #       #         #     #        #     #         #      #   #
#       #     #    #       #         #     #        #     #         #      #   #
#       #     #    #       #         #     #        #     #         #      #   #
#       #     #            #    #    #     #        #     #         #      #   #
#       #     #            #    #    #     ###      #     #         #      #   #
#       #     #            #    #    #     #        #   ##          #      #   #
#       #     #         ## #    #    #                              #      #   #
#       #     #    #            #    #                              #      #   #
#       #     #    #            #    #                              #      #   #
#       #     #    #            #    #                    #         #          #
#       #     #    #            #    #     #              #         #          #
#       #     #    #       #    #    #     ###    ####### #         #          #
#       #     #    #       #    #    #     #       #      #         #          #
#       #     #    #       #    #    #     #       #      #         #      #   #
#       #     #    #       #    #    #     #       #      ###    ## ###    #   #
#                          #    #    #     #       #      #         #      #   #
###############    ####### #    #    #     #       #      #         #      #   #
#     #       #       #    #    #    #     #       #      #         #      #   #
#     #       #       #    #    #    #     #       #      #         #      #   #
#     #       #       #    #    #    #     #       #      #         #######    #
#     #       #       #    #    #    #     #       #      #         #     #    #
#     #       #       #    #    #    #     #       #      #         #     #    #
#     #       #       #    #    #    #     #       #      #               #    #
#     #       #       #    #    #    #     #       #      #               #    #
##    #       ###    ##    #    #    #     #       #      #               #    #
#      ####   #            #    #    #     ##      #      #               #    #
#             #            #    #    #     #       #      #         #     #    #
#             #            #    #    #     #       #      #         #     #    #
#             #            #    #    #     #       #      #         #     #    #
#             ####    #### #    #    #     #       #      #         #     #    #
#             #      #     #    #    #     #       #   ## #         #     #    #
#  ########## #      #     #    #    #     #       #      #         #     #    #
#        #    #      #     #    #    #     #       #      #         #    ##    #
#        #    #      #     #    #    #     #       #      #         #          #
#        #    #      #     #    #    #     #       #      #         #          #
#        #    #      #     #         #     #       #      #         #          #
#        #    #      #     #######   #     #       #      #         #          #
#        #    #      #     #    #    #     #       #      #                    #
#        #    #      #     #    #    #     #       #      ####    ##############
#        #    #      #     #    #    #     #              #                    #
#        #    #      #     #    #    #     #              #                    #
#        #    #      #     #    #          #              #                    #
#        #    #      #     #               #              #               #    #
#        #    #      #     #               #              #               #    #
###      #    #      #     #                                                   #
#        #    #      #     ###########################    ######################
#        #    #      #     #     #                             #          #    #
#        #    #      #     #     #                             #          #    #
#        #    #      #     #                                   #          #    #
#        #    #      #     #                                   #          #    #
#        #           #     #                                   #    ##### #    #
#        #                 ####################    ############           #    #
#        #                 #        #                                          #
#        #                 #        #                                          #
#        #    #            #        #                                          #
#        #    #      #     #                                   ####    #########
#             #      #     #                                   #               #
#             #      #     #                   *               #               #
#             #      #     #                                   #               #
################################################################################
