80 80
################################################################################
#        #    #                              #                                 #
#        #    #                              #                                 #
#        #    #                              #                                 #
#        #    #                              #                          #      #
#        #    #                              #######################    #      #
#    ### #    #                              #                          #      #
#        #    ###    ########################                           ##    ##
#        #    #      #       #    #     #                               #      #
#        #    #      #       #    #     #                               #      #
#        #    #              #    #     #                               #      #
#             #              #          #    #                          #      #
#             #              #          #    ###########################    ####
#             #              #          #    #    #     #                      #
#             #      #####   #          #    #    #     #                      #
#        #    #      #       #    #     #    #    #     #                      #
#        #    #      #       #    #     #    #    #     #                      #
#        #    #      #            #     #    #    #     ##########    ##########
#        #    #      #            #     #    #    #     #     #     #    #     #
#        #    #      #            #     #    #    #     #     #     #    #     #
#        #    ##     #            #     #    #    #     #     #     #    #     #
#        #    #      #   ######## #     #    #    #     #     #     #    #     #
#        #    #      #            #     #    #    #     #     #     #    #     #
#        #    #      #            #     #    #    #     #     #     #    ##    #
#        #    #      #            #     #    #    #     #     ##    #    #     #
#        #    #                   #     #    #    #     #     #     #    #     #
#        #    ##    ############# #     #    #    #     #     #     #    #     #
#        #    #        #     #    #     #    #    #     #     #     #          #
#        #    #        #     #    #     #    #    #     #     #     #          #
#        #    #        #     #    #     #    #    #     #     #     #          #
#        #    #        #     #    #     #    #    #     #           #          #
#             #        #     #    #     #    #    #     #           #          #
#    ######## ##    ## #          #     #    #    #     #           #########  #
#       #     #                   #     #    #    #     #           #     #    #
#       #     #                   #     #    #    #     #     #     #     #    #
#       #     #                   #     #    #    #     #     #     #     #    #
#       #     #         ######    #     #    #    #     #     #     #          #
#       #     #        #     #    #     #    #    #     #     #     #          #
#       ###            #          #     #    #    #     #           #          #
#       #              #          #     #    #    #     #    ###### #      ##  #
#       #              #          #     #    #    #     #      #     ##   #    #
#       #                               #    #    #     #      #          #    #
#    ###      ###    ################## #    #    #     #      #          #    #
#             #              #          #    #    #     #      #          #    #
#             #              #          #    #    #     ##     #    #     #    #
#             #                         #    #    #     #      #    #     #    #
#       #     #                              #    #                 #     #    #
#       #     #                              #    #                 #     #    #
#                                            #    #                 #     #    #
###    ##################################### #    #                 #     #    #
#      #                        #     #      #    #     #      #    #     #    #
#      #                        #     #      #    #     #      #  * #     #    #
#      #                        #            #    #     #      #    #     #    #
#      #                        #            #    #                 #          #
#      ####    ################ #            #    ################    ##########
#      #          #      #      #            #    #     #       #              #
#      #          #      #      #     #      #          #       #              #
#      #          #      #      #     #      #          #       #              #
#      #          #      #      #     #      #          #       #      #       #
#      #          #      ###    #            #              ### #      #    ####
#      #######    #      #      #    ####### #    #             #      #       #
#      #     #    #      #      #       #    #    #             #      #       #
#      #     #    #                     #    #    ##            #      #       #
#      #     #    #                     #    #    #     #       #      #       #
#      #     #    #   ###               #    #    #     #       #      #       #
#      ###   #    #                 ### #    #    #     #       #      #       #
#            #    #      #      #       #    #    #             #      #       #
#                 #      #      #       #    #    #   ######### ####    ########
#                 #             #       #    #    #       #     #              #
###               ########      #       #    #    #       #     #              #
#      #                        #       #    #    #       #     #              #
#      #     #                  #       #    #    #       #     #      #       #
#      #     #                  #       #    #    #       #     #      #       #
#                               #       #    #    #   ### #     #      #####   #
##################    ######### #       #    #    #             ####   #       #
#                               #       #    #    #             #      #       #
#                               #            #    #             #      #       #
#                               #            #    #                    #       #
#                               #            #    #       #            #       #
################################################################################
