80 80
################################################################################
#      #           #    #    #                                         #       #
#      #           #    #    #                                         #       #
#      #    #      #    #    #                                         #       #
#      #    #           #    #################    #################### #       #
#      #    #           #    #                                         #       #
#      #    #           #                                              #       #
#      #    #           #                                              #       #
#  ### #    #      #    #                                              #       #
#      #    #      #    ####################    ###################### ###    ##
#      #    #      #    #                                              #       #
#      #    #      #    #                                                      #
#      #    #      #    #                                                      #
#      #    #      #    #                                                      #
#      #    #      #    ################    ####################################
#      #    #      #    #       #              #     #               #     #   #
#      #    #      #    #       #              #     #               #     #   #
#      #    #      #    #       #              #     #               #     #   #
#      #    #      #    #       #    #         #              #      #     #   #
#      #    #      #    #       #    #    #    #              #      #         #
#      #    #      #    #       #    #    #    #              #      #         #
#      #    #      #    #       #    #    #    #              #      #         #
#      #    #      #    #       #    ###    ## ########    ## #      #         #
#      #    #      #    #       #    #         #         #    #      #     #   #
#      #    #      #    #       #    #         #         #    ####   #     #   #
#      #    #      #    #       #    #         #         #    #      #     #   #
#      #    #      #    #       #    #         #         #    #      #     #   #
#      #    #      #    #       #              ##    ### #    #      #     #   #
#      #    #      #    #       #########      #         #    #      #     #   #
#      #    #      #    #       #      #       #              #      #     #   #
#      #    #      #    #       #      #       #              #      #     #   #
#      #    #      #    #       #      #       #              #      #     #   #
#           #           #       #      #       #                     #     #   #
#           #   ####### #       #      #       #################     #     #   #
#           #    #              #      #       #    #    #           #     #   #
#           #    #              #      #       #    #    #           #     #   #
#      #    #    #              #      #       #    #    #           #     #   #
#      #    #    #             *#      #       #    #    #           #     #   #
#      #    #    #      #       #      #       #         #           #     #   #
#           #    #      #       #      #       #         #      #    #     #   #
#    ###### #    #      #       #      #       #         #      #          #   #
#      #    #    #      #       #      #       #         #      #          #   #
#           #    ####   #       #      #       #    #           #          #   #
#           #    #      #       #      #       #    #           #     ###    ###
#           #    #      #       #      #       #    #     ##    #    #         #
#           #    #      #       #      #   ### #    #           #    #         #
#      #    #    #      #       #      #       #    #    #      #    #         #
#      #    #    #      #       #      #       #         #      #    #     #   #
#      #    #    #      #       #              #    #### #           #     #   #
#      #    #    #      #       #              #    #    ###    #### #     #   #
#      #    #    #      #       #              #         #      #    #     #   #
#      #    #    #      #                      #         #      #    #     #   #
#      #    #    #      #             ##       #         #           #     #   #
#      #    #    #      #              #       #         #           #     #   #
#      #    #    #      #              #       #    #    #           #     #   #
#      #    #    #      #       #      #       #    #                          #
#      #    #    #      #       #      #       ##    ###########################
#      #    #    #      #       #      #       #         #               #     #
#      #    #    #      #       #      #       #         #               #     #
#      #    #    #      #       #      #       #         #               #     #
####   #    #    #      #       #      #       #         #               #     #
#      #    #           #       #      #       #                         #     #
#      #    #           #       #      #       #                         #     #
#      #    #           #       #      #       #                         #     #
#      #    #           #       #      #       #                         #     #
#           #           #    ## #      #       ##################    ### #     #
#########    ########## #       #      #       #              #          #     #
#    #        #    #    #       #      #       #              #          #     #
#    #        #    #    #       #      #       #              #          #    ##
#    #        #    #    #       #      #       #                               #
#    #             #    #                      #                    #          #
#                       ##    ################ #                    #          #
#                       #                                           #          #
#                       #                                           #    #     #
##    ####### ###    ## #                          ################ #    #     #
#             #         #               #                 #         #    #     #
#             #         #               #      #                    #    #     #
#             #         #               #      #                    #    #     #
#             #         #               #      #                    #    #     #
################################################################################
