80 80
################################################################################
#                         #         #      #    #                   #      #   #
#                         #         #      #    #                   #      #   #
#                         #         #      #    #                   #      #   #
#                         ######    #      #    ############    ### #      #   #
###############    ###### #         ##     #    #     #    #        #      #   #
#                                   #      #    #     #    #        #      #   #
#                                   #      #    #     #    #        #      #   #
#                                   #      #    #     #    #        #      #   #
#                                   #      #    #     #    #        #      #   #
#####    ########################## #      #    #     #    #        #      #   #
#    #       #    #    #            #      #    #     #    #        #      #   #
#    #       #    #    #            #                 #    #        #      #   #
#    #       #    #    #            #                 #    #        #          #
#    #       #    #    #            #                 #    #        #          #
#            #    #    ##    ###### #                 #    #        #          #
#            #    #    #     #      #      #    #     #    #        #          #
#            #    #    #     #      #      #    #          #        #      #   #
#            #    #    #     #      #      #    #          #        #      #   #
#    #       #    #    #     #      #      #    #          #        #      #   #
#    #       #    #    #     #      #      #    #          #        #      #   #
#    #       #    #    #     #      #      #    #     #    #        ###    #   #
#    #       #    #    #     #      #      #    #     #    #        #      #   #
#    #       #    #    #     #      #           ####    ###         #      #   #
#    #       #    #    #     #      #    ###### #     #             #      #   #
#    #       #    #    #     #      #           #     #     ##      #      #   #
#    #       #    #    #     #      #           #     #             #      #   #
#    #       #    #          #      #           #     #    #               #   #
#    ##      #    #          #      #           #     #    #               #   #
#    #       #    #          #      #      #    #    *     #               #   #
#    #       #    #          #      #      #    #          #               #   #
#    #       #    #    #     #      #      #    #          #        #      #   #
#    #       #    #    #     #      #      #    #          #        #      #   #
#    #       #    #    #            #      #                        #      #   #
#    #       #    #    #            ####    ####################### #      #   #
#    #       #    #    #            #     #      #         #        #      #   #
#    #       #    #    #            #     #      #         #        #      #   #
#    #       #    #    #     #      #     #      #         #        #      #   #
#    #       #    #    #     #      #     #      #         #        #      #   #
#    #       #    #    #            #     #      #         #        #      #   #
#    #       #    ##    ########### #     #      #         #        #      #   #
#    #       #    #          #      #     #      #                  #######    #
#    #       #    #          #      #     #      #                  #      #   #
#    #       #    #          #      #     #      #                  #      #   #
#    #       #    #          #      #     #      #                  #      #   #
#    #       #    ########   #      #     #      #         #        #      #   #
#    #       #         #     #      #     #      #         ####     #      #   #
#    #       #         #     #      #     #      #         #        #      #   #
#    #       #         #     #      #     #      #         #        #      #   #
#    #       #         #            #     ##     #         #        #      #   #
##   #       #    #    #            #            #         #        #      #   #
#    #       #    #    ##           #            #         #        #      #   #
#    #       #    #    #          ##             ####      #        #      #   #
#    #       #    #    #     #                   #         #        #          #
#    #       #    #          #       ######      #         #        #          #
#    #       #    #          #            #      #         #        #          #
#    #       #                      #     #      #                  #          #
#    #       ######    ############ #     #      #    ############# #      #   #
#    #       #       #       #      #     #      #      #      #    #      #   #
#    #       #       #       #      #     #             #      #    #      #   #
#    #       #       #       #      #     #                    #    #      #   #
#            #       #       #      #     #                         #      #   #
##########   #       #       #      #     #                         #      #   #
#   #        #       #       ##     #     #      #                  #      #   #
#   #        #       #    ## #      #     #   ## #      ####    ### #      #   #
#   #        #       #       #      #     #      #      #           #      #   #
#   #                #              #     #      #      #           #      #   #
#   #         ###    #              #     #      #      #           #      #   #
#   #                #              ###          #      #     #     #      #   #
#   #                #              #            #      #     #     #      #   #
#            #       #              #            #      #     #     #      #   #
#            #       ############   #            #      #     #     #      #   #
#            #       #       #      #     #                                    #
#            #       #              ##    ######################################
#   #####    #       #              #                                          #
#   #        #                      #                                          #
#   #        #                      #                                          #
#   #        #               #      #                  #                       #
#   #        #               #      #                  #                       #
################################################################################
