80 80
################################################################################
#      #                         #        #       #       #      #    #    #   #
#      #                         #        #       #       #      #    #    #   #
#      #                         #        #       #       #      #    #    #   #
#      #                         #        #       #       #      #    #    #   #
#      #                         #        #       #       #      #    #    #   #
#      ###    ################## #        #       #       #      #    #    #   #
#      #          #        #     #        #       #       #      #    #    #   #
#      #                   #     #        #       #       #      #    #    #   #
#      #                   #     #        #       #       #      #    #    #   #
#      #                   #     #        #       #       #      #    #        #
#          ####### #####   #     #        #####   #       #      #    #        #
#                 #        #     #        #       #       #      #    #        #
#                 #        #     #        #       #       #      #    #        #
#                 #        #              #       #       #      #    #    #   #
#      #          #        #              #       #       #      #    #    #   #
#      ########    ####### #              #       #       #      #    #    #   #
#      #             #     #              #       #       #   ## #         #   #
#      #                   #     #        #       #   ### #      #         #   #
#      #                   #     #        #       #       #      #         #   #
#      #                   #     #        #       #       #      #         #   #
#      ########    ##      #     #        #       #       #      #    #    #   #
#      #             #           #        #       #       #      #    #    #   #
#      #             #           ##    ## #       #       #      #    #    #   #
#      #             ###         #        #       #       #      #    #    #   #
#      #             #           #        #       #       #      #    #    #   #
#      #             #     #     #        #       #       #      #    #    #   #
#      #             #     #     #        #       #       #      #    #    #   #
#      #                                  #       #       #      #    #    #   #
#      ###    ########################### #       #       #      #    #    #   #
###    #                          #       #       #       #           #    #   #
#      #                                  #       #       #           #        #
#      #                                  #       #       #           #    #####
#      #                    #             #       #       #           #    #   #
#      #    ######### #     #             #               #      #    #    #   #
#      #              #     #             #               #      #    #    #   #
#      #              #     ##########    #               #      #    #    #   #
#      #              #     #    #        #               #      #    #    #   #
#      #                    #    #        #   ########### #      #    #    #   #
#      ######    ########## #    #        #         #            #    #    #   #
#      #                    #    #          *       #            #    #    #   #
#      #                    #                                    #    #    #   #
#      #                    #                                    #    #    #   #
#      #       #            #     ##    ## ####           #      #    #    #   #
#      #       #            #             #               #      #    #    #   #
#      #       #            #    #        #         #     #      #    #    #   #
#      #       #            #    #        #         #     #      #    #    #   #
#                                         #                      #    #    #   #
####################    ################# ##################     #    #    #   #
#     #          #    #                   #    #          #      #    #    #   #
#     #          #    #                   #    #          #      #    #    #   #
#     #               #                   #    #          #      #    #    #   #
#     #               #                   #    #          #      #    #    #   #
#     #######         #########    ###### #    #    ##### #      #    #    #   #
#     #     #         #              #    #    #          #      #    #    #   #
#     #     #    #    #                   #    #          #      #    #    #   #
#     #          #                        #    #          #      #    #    #   #
#     #          #                        #    #          #      #    #    #   #
#     #          #             #          #          #    #      #    #    #   #
#                #             #          #          #    #      #    #    #   #
#                     #        #   ###### #          #    #      #    #    #   #
#      ##    ######## ####     #          ##########      #      #    #    #   #
#                     #        #          #      #        #      #    #    #   #
#     #               #        #          #      #        #      #    #    #   #
#     #               #        #          #      #        #      #    #    #   #
#     #                                   #      #        #      #    #    #   #
#     ##############################      ####   ##    ## #      #    #    #   #
#     #                                   #               #      #    #    #   #
#     #                                   #               #      #    #        #
#     #                                   #                      #    #        #
#     #                                   #                      #    #        #
#                                                                #             #
#######################    ##################################### ############  #
#                          #                                     #     #       #
#                          #                                     #     #       #
#                          #                                     #     #       #
#                                                                #     #       #
#                                                                #             #
#                                                                #             #
################################################################################
