80 80
################################################################################
#                                                        #        #            #
#                                                        #        #            #
#                                                        #        #            #
#                                                        #        #     #      #
##########################    ########################## #        #     #      #
#        #     #    #                         #    #     #        #     #      #
#        #     #    #                         #    #     #              #      #
#        #     #                              #    #     #              #      #
#        #     #            #                 #    #     #              #      #
#   #    #     #            #        #             #     #              #      #
#   #    #     #            #        #             #     #        #     #      #
#   #    #     #    #       ####     #             #     #        #     #      #
#   #    #     #    #####   #        #             #     #        #     #      #
#   #    #     #    #       #        #   ######### #     #        #     #      #
#   #    #     #    #       #        #             ##    #        #     #      #
#   #    #     #    #       #        #                   #        #     #      #
#   #    #     #    #       #        #                   #        #     #      #
#        #     #    #       #        #                   #        #     ###    #
#####    #     #    #       #        #                   #        #     #      #
#   #    #     #    #       #        #########    ###### #        #     #      #
#   #    #     #    #       #        #     #        #    #        #     #      #
#   #    #     #    #       #        #     #        #    #        #     #      #
#   #    #     #    #       #        #     #        #    #        #     #      #
#   #    #     #    #       #        #              #    #        #     #      #
#   #    #     #    #       #        #              #    #        #     #      #
#   #    #     #    #       #        #              #    #        #     #      #
#   #    #     #    #       #        ####    ###### #    #        #     #      #
#   #    #          #       #        #              #    #        #     #      #
#   #    #          #       #        #              #    #        #     #      #
#   #    #          #       #        #              #    #        #     #      #
#   #    #          #       #        #              #    #        #     #      #
#   #    #     #    #       #        #     #        #    #        #     #      #
#              #    #                #     #             #        #     #      #
#              #    ##########    ## #     #####         #        #     #      #
#              #    #      #         ##    #             #        #     #      #
#              #    #                #     #             #        #     #      #
#              #    #                #     #        #    ###      #     #      #
#              #    #                #     #        #    #        #     #      #
#  ########### #    #                      #             #        #     #      #
#   #    #     #    ######################    ########## #        #     #      #
#   #    #     #    #        #                           #        #     #      #
#   #    #     #    #        #                           #        #     #      #
#   #    #     #    #        #                           #        #     #      #
#   #    #     #    #        #                  #        #        #     #      #
#   #    #     #    ####     #                  #        #        #     #      #
#        #     #    #        #                           #        #     #      #
#        #     #    #        ##########    ############# #        ###   #      #
#        #     #    #                                    #        #     #      #
#        #     #    #                                    #        #     #      #
#   #    #     #    #                                    #        #     #      #
#   #    #     #                                         #        #     #      #
#   #    #     ######################    ############### #        #     #      #
#   #    ##    #         #                          #    #        #     #      #
#   #    #     #         #                          #    #        #     #      #
#   #    #     #                                    #    #        #     #      #
#   #    #     #                                    #    #        #     #      #
#   #    #     #                                    #    #        #     #      #
#   #    #     ##############    ################## #    #        #     #      #
#        #     #     #            #    #            #    #        #     #      #
#   #### #     #     #            #                 #    #        ###    #######
#   #    #     #     #            #                 #    #        #     #      #
#   #          #     #            #                 #    #        #     #      #
#   #          #     #            #                 #    #        #     #      #
#   #          #     #       #    ############      #    #        #     #      #
#   #          #     #       #         #            #    #        #     #    ###
#   #    #     #     #       #         #            #    #        ###          #
#   #    #     #     ########          #            #    #  *     #            #
#   #    #     #     #                              #    #        #            #
#   #    #     #     #            #                 #    #        #            #
#   #    #     ##                 #                 #    #        #     #      #
#   #    #     #                  #                 #    #              #      #
#   #    #     #                  #                 #    #############    ######
#   #    #     #      ##########    ############### #    #        #            #
#   #    #     #     #            #                               #            #
#   #    #     #     #            #                               #            #
#   #    #     #     #            #                                            #
#        #     #     #                                                         #
#        #     #     #                              #    #                     #
################################################################################
