80 80
################################################################################
#                                    #    #               #          #    #    #
#                                    #                    #          #    #    #
#                          #         #                    #          #    #    #
#                   #      ######          ######    #### ##    #    #    ##   #
##########    ##### #      #                    #         #     #    #    #    #
#       #     #     #      #              #     #         #     #    #         #
#       #     #     #      #              #     #         #     #    #         #
#       #     #     #      #              #     #         #     #    #         #
#             #     #      #   ########## #     #    #### ######    #########  #
#             #     #      #              #     #         #                    #
#             #     #      #              #               #                    #
#             #     #      #              #               #                    #
#             #     #      #                              #                    #
########      #     #      #########################      #################    #
#      #      #     ##     #       #     #      #         #     #        #     #
#      #      #     #      #       #     #      #         #     #        #     #
#      #      #     #      #       #     #                #     #        #     #
#      #            #      #             #                #     #        #     #
#      #            #      #             #                #              #     #
#      #            #      #             #                #              #     #
#      #            #      #   ######### #####    ####### #              #     #
#      #      #     #      #    #        #         #      #         #### #     #
#      #      #     #      #    #        #         #      #     #        #     #
#      #      ##    #      #    #        #         #      #     #        #     #
#      #      #     #      #    #        #         #      #     #        #     #
#      #      #     #      #    #              ### #      #     #        #     #
#   ## #      #     #      #    #                  #      #     #        #     #
#      #      #     #      #    ####               #      #     #        #     #
#          ## #     #      #                       ##     #     #        #     #
#             #     #      #             #    #           #     #              #
#             #     #      #             #    #           #                    #
#             #     #      #             #    #           #   ###########      #
#      #      #     #                    #                #         #          #
#      #      #     #####################   *############ #         #    #     #
#      #      #     #           #                         #         #    #     #
#      #      #     #           #                         #    #    #    #     #
#      #      #     #           #                         #    #    #    #     #
#      #      #     #           #                         #    #    #    #     #
#      #      #     ##    ###### #######    ############# #    #    #    #     #
#      #      #     #                                     #    #    #    #     #
#      #      #     #                                     #    #    #    #     #
#      #      #     #                                     #    #    #    #     #
#                                                         #    #    #    #     #
########################################    ############# #         #    #     #
#                                              #     #    #   ##### #    #     #
#                                              #     #    #    #    #    #     #
#                                              #          #    #         #     #
#   #                                          #          #    #         #     #
#   #         #                                #          #    #         #     #
#             #####    ####################### #          #    #         #     #
########      #                #                     #    #    #    #    ##    #
#             #                #                     #    #    #    #    #     #
#             #                #                     #    #    #    #    #     #
#             #                #                     #         #    #    #     #
#             #                                #     #              #    #     #
#             #                                #     #              #    #     #
#                                              #     #              #    #     #
##########################################     #     #    #         #    #     #
#        #                        #       #    #     #    #    #    #    #     #
#        #                        #       #    #     #    #    #    #    #     #
#        #                        #       #    #     #    #    #    #    #     #
#   #    #                        #       #    #     #    #    #    #    #     #
#   #    #                        ####    #    #     #    #    #    #    #     #
####     ######################   #            #     #    #    #    #    #     #
#   #    #                        #            #     #    #    #    #    #     #
#   #    #                                     #     #    #    #    #    #     #
#        #                                     #     #    #    #    #    #     #
#        #        #                       #    #     #    #    #    #    #     #
#        ##    ## #   ############        #    #     #    #    #    #    #     #
#                 #               #       #    #     #    #    #    #    #     #
#   #             #               #       #    #     #    #    #    #    #     #
#   #             #               #       #    #     #    #    #    #    #     #
#   #             #               #####    ### #          #    #    #    #     #
#        #                        #            #    ##### #    #    #    #     #
#####    ######################## #            #          #    #    #    #     #
#                                 #            #          #    #    #    #     #
#                                 #    #       #          #    #    #    #     #
#                                 #    #       #    #     #    #    #    #     #
################################################################################
