80 80
################################################################################
#        #       #                #                         #    #        #    #
#        #       #                #                              #        #    #
#   #    #       #                #                              #        #    #
#   #    #       ######    ###### #                              #        ##   #
#   #    #       #     #          #################    ######### #        #    #
##    ## #    ###      #          #               #      #       #        #    #
#   #    #             #          #               #      #                #    #
#   #    #             #    #     #               #      #                #    #
#   #    #             #    #     #     #    #    #      #                #    #
#   #    #       #     #    #     #     #    #    #      #                #    #
#        #       #     #    #     #     ##    ### #      #       #        #    #
#        #       #     #    #     #     #         #              #        #    #
#                ###   #    #     #     #         #              #        #    #
#                #          #     #     #         #              #        #    #
#                #          #     #               #              ######        #
#                #          #     #   ########### #      #       #             #
#######    ##### #          #     #    #    #     #      #       #             #
#      #         #          #     #    #    #     #      #       #             #
#      #         #          #     #    #    #     #      #       #        #    #
#      #         #######    #     #         #     #      #       #        #    #
#                #          #     #         #     #      #       #        #    #
#                #          ###   #         #     #      #       #        #    #
#  ####          #          #     #         #     #      #       #        #    #
#       ###      #    #     #     #######   #     #      #       #             #
#      #         #    #     #     #    #    #     #      #       ############  #
#      #         #    #     #     #    #          #      #       #         #   #
#      #         #    #     #     #    #          #      #       #         #   #
#                #                #    #          #      #       #             #
#################    ############ #    #          ###    #       #             #
#                           #     #    #    #     #      #       #    #        #
#                           #     #    #    #     #      #       #    #        #
#                           #     #    #    #     #      #####   #    #    #   #
#                           #          #    #     #      #       #    #    #   #
#########    ### ##    #####           #    #     #      #       #    #    #   #
#                #                     #    #     #      #       #    #    #   #
#                #                     #    #     #              #    #    #   #
#                #                #         #     #########      #    #    #   #
#                #          #     #         #     #              #    #####    #
#                           #     #         #                    #    #        #
#########################   #     #         #                    #    #        #
#      #    #       #       #     #         #                    #    #        #
#      #    #       #       #     #                              #             #
#      #    #       #       #     ###############################    ###########
#      #    #       #       #     #       #      #                     #       #
#      #    ####    #       #     #       #      #                     #       #
#      #    #               #     #       #      #                             #
#      #    #               #     #       #      #        #      #             #
#      #    #               #     #       #      #        #      ###       #####
#      #    #               #     #       # *    #        #      #             #
#      #    #       #       #     #       #      #        #      #     #       #
#      #    #       #       #     #       #      #        #      #     #       #
#      #    #       #       #     #       #      #        #      #             #
#      #    #       #       #     #       #      #        #      #########    ##
#           #       #       #     #       #               #      #             #
#           #       #       #     #       #               #      #             #
#           #       #       #     #       #               #      #             #
##    ##### #       #       #     #       ###             ##     #        #    #
#      #    #       #       #     #       #      #        #      #        #    #
#      #    #       ##      #     #       #      #        #      #        #    #
#      #    #       #       #     #       #      #        #      #        #    #
#      #    #       #       #     #       #      #        #                    #
#      #    #       #       #     #       #      ####     #################    #
#           #       #       #     #    ###       #        #              #     #
#           #       #       #     #              #        #                    #
#           ########    ### #     #              #        #                    #
#           #    #          #     #              #        #                    #
#      #    #    #          #     #       #      #        #        #           #
#      #    #    #          #     #       #      #        #        #     #     #
#      #    #    #          #     ######    #### #        #        #     #     #
###    #         #          #     #              #        ######   ###    ######
#      #         #          #     #              #        #        #      #    #
#      #          #####     #     #              #        #        #      #    #
#      #               #    #     #                       #        #           #
#      #    #          #    #     #####    ############## #        #           #
#      #    #               #     #                       #        ##          #
#      #    #    #          #     #                       #        #           #
#      #    #    #          #     #                       #        #      #    #
#      #    #    #          #     #                       #        #      #    #
################################################################################
