80 80
################################################################################
#       #      #                   #    #     #      #     #     #      #      #
#              #                   #    #     #      #     #     #      #      #
#              #                   #          #      #     #     #      #      #
#              #                   #          ##     #     #     #      #      #
###########    #    #### #         #          #      #     #     #      #      #
#                        #         #          #      #           #      #      #
#                        #         #          #                  #      #      #
#                        #         #####      #                  #      #      #
#                        #         #    #     #                  #      #      #
######    ############## #         #    #     #            #     #      #      #
#   #        #      #    #         #    #     ########     #     #      #      #
#            #      #    ####      #    #     #            #     #      #      #
#            #           #         #          #            #            #      #
#            #           #         #          #            #            #      #
#            #           #         #                       #            #      #
#            #           #         #        ##                          #      #
#######      ###    #    #         #    #      ##    ########### #      #      #
#   #        #      #    #         #    #                   #    #      #      #
#   #        #      #    #         #    #     #             #    #      #      #
#   #        #      #    #         #    #     #             #    #      #      #
#            #      #    #         #    #     #                  #      #      #
#            #      #    #         #    #     #                  #      #      #
#                   #    #         #          #                  #      #      #
#        ####       #    #         ########    ################# #      #      #
#   #               #    #         #                 #    #      #      #      #
#   #               #    #         #                 #    #      #      #      #
#   #        #      #    #         #                 #    #      #      #      #
#   #        #      #    #         #           #     #    #      #      #      #
#                   #    #         #           #     #    #      #      #      #
#########    ###### #    #         #           #     #    #      #             #
#                   #    #         ############      #    #      #             #
#                   #    #         #            #    #    #      #             #
#                   #    #         #            #    #    #      #             #
#                        #         #                 #    #      ###    #      #
#######################    ####### #                 #    #      #      #      #
#     #      #     #      * #      #       #         #    ####   #      #      #
#     #      #     #        #      #####   #    #####     #      #      #      #
#     #      #     #        #      #       #    #         #      #      #      #
#     #      #     #               #       #              #      #      #      #
#     #      #     #               #       #              #      #      #      #
#  ## ##           #               #       #         #    #      #      #      #
#     #            #               #       #         #    #      #      ####   #
#     #                 ### #      #                      #      #      #      #
#     #                     #      #    ################# #      #      #      #
#     #      #              #   ## #    #      #    #     #      #      #      #
#     #      #              #      #    #      #    #     #      #      #      #
#     #######      #        #      #    #      #    #     #      #      #      #
#     #      #     #        #      #    #      #    #     #      #      #      #
#     #      #     #        #      #    #      #    #     #      #      #      #
#     #      #     #        #      #    #    ##     #     #      #      #      #
#     #      #     #########    ## #    #           #     #      #      #      #
#     #      #     #               #    #           #     #      #             #
#     #      #     #               #                #     #      ##########    #
#            #     #               #           #    #     #      #     #       #
#            #     #               #           #    ##    #      #     #       #
#                  #       ###     #                #     #      #     #       #
#                  #       #       #    ###    #### #     #      #     #       #
#                  #       #       #    #           #     #      #     #       #
###    ########### #       #       #    #           #     #      #     #       #
#     #            #       #       #    #                 #      #     #       #
#     #            ##      #       #    #                 #      #     #       #
#     #            #       #       #    #                 #      #     #       #
#     #            #       #            #                        #     #       #
#  ## #########    #       #        ##    ######### #            #     #       #
#                  #       #                        #            #     #       #
#                  #       #                        #            #     #       #
#                  #       #                        #            #     #       #
#                                                                #     #       #
##############################################    ############## #     #       #
#                                                                #     #       #
#                                                                #     #       #
#                                                                #     #   #####
#                                                                #     #       #
######################    ############################ ####      #     #       #
#                                                      #         #             #
#                                                      #         #             #
#                                                      #         #             #
#                                                      #         #             #
################################################################################
