80 80
################################################################################
#     #    #                                      #      #              #      #
#     #    #                                      #      #                     #
#     #              #                            #      #                     #
#     #              #                            #      #                     #
#     #              #                            ##     #                     #
#     ##    ######## #                            #      #              #      #
#     #      #       #######################      #      #########      #      #
#     #      #       #                #           #      #              #      #
#     #              #                #           #      #              #      #
#     #              #                #           #      #              #      #
#     #              #                            #                     #      #
#     #              #                            #              #   ## #      #
#     #                                           #              #      #      #
#     ######################################      #              #      #      #
#     #     #                      #              #              #      #      #
#     #     #                                     #                     #      #
#     #     #                                     #    ################ #      #
#     #     #                                     #     #               #      #
#     #     #                                     #     #               #      #
#     #     ############################    ##### #     #               #      #
#     #     #                                     #     #               #      #
#     #     #                                     #     #               #      #
#     #                                           #   ## ###########    #      #
#     #                             #             #                     #      #
#     #                             #                                   #      #
#     #                             #                                   #      #
#     #                             #                                   #      #
#     #                                                                 #      #
#     ########################################    ##################### ###    #
#     #    #    #                  #          #      #                  #      #
#     #    #    #                  #          #      #                  #      #
#     #    #    #                  #          #                         #      #
#     #         #                  #          #                         #      #
#     #         #######    ####### #    ##### #                         #      #
#     #         #                                                       #      #
#     #         #                                                       #      #
#     #    #    #                              ############    ######## #      #
#     #    #    #                                              #        #      #
#     #    #    ########    ################# #                #        #      #
#     ##    ### #                     #       #                         #      #
#     #    #    #                     #       #                         #      #
#     #    #                                  ###########    ## #####   #      #
#     #    #                                  #                         #      #
#     #    #                                  #                #        #      #
#     #                                       #                #        #      #
#     #         #                                                       #      #
#     #         ##################################    ################# #      #
#     #         #                                                       #      #
#     #    #    #                                                       #      #
#     #    #    #                                                       #      #
#     #    #    #                              #                        #      #
#     #    #    #    ######################### #                        #      #
#     #    #    #                              #                        #      #
#     #    #    #                              ########    ############ #      #
#     #    #    #                              #                   #    #      #
#     #    #    #                   #          #                        #      #
#     #    #    #                   #          #                        #      #
#     #    #    #                   #          #                        #      #
#     #         #                                                              #
#     ########    ##############################################################
#     #                                                         #              #
#     #                                                         #              #
#     #                                                                        #
#     #     #               #                                                  #
#     ###   #############   #                                                  #
#     #     #               #    ###############################################
#     #     #               #           #      #                               #
#     #     #               #           #      #                               #
#     #                     #                                                  #
#     ############    ##### #                                       #          #
#            #              #          *                            #          #
#                           #    ##############                                #
#                           #                  ##########################    ###
#                           #                  #                               #
#     ###     ##########    #                  #                               #
#     #      #              #                  #                               #
#     #      #              #       #          #     #                         #
#     #      #              #       #          #     #                         #
################################################################################
