80 80
################################################################################
#      #        #          #                                  #    #      #    #
#      #        #          #                                  #    #      #    #
#      #        #    #     #                   #              #    #      #    #
#      #        #    #     #                   #              #           #    #
#      #        #    ##    #                                  #           #    #
##    ##        #    #     #########################    ##### #           #    #
#               #    #     #                     #                  ##### ##   #
#               #    #     #                     #                   #    #    #
#       ###     #    #     #                     #                        #    #
#               #    #     #                     #                        #    #
#      #        #    #     #                #    #   ######## #                #
#      #        #    #     #                #    #     #      #                #
#      #        #    #     #################     #     #      #                #
#               #    #     #                     #     #      #####    #########
##########      #    #     #                     #     #      #                #
#   #    #      #    #     #                     #     #      #                #
#   #    #      #    #     #        #                         #                #
#   #    #      #    #     #        #                         #                #
#   #    #      #    #     #                                  #                #
#   #    #      #    #     #################################    ################
#        #      #    #     #       #       #                   #               #
#        #      #    #     #       #       #                   #               #
#        #      #    #     #               #                   #               #
#        #      #    #     #               #                   #               #
#  ##### #      #    #     #               #                   #########    ####
#   #    #      #    #     ##########      #    ###############        #       #
#   #           #          #     #         #                                   #
#   #           ########   #               #                                   #
#   #           #          #               #                                   #
#   #           #          #                                   ####     *      #
#   #    #      #          #                                   #       #       #
#   #    #      #          #                                   #       #       #
#   #    #      #    #      ############    ################## #       ##    ###
#   #    #      #    #                                         #       #       #
#   #    #      #    #                                         #       #       #
#   #    #      #    #                                         #       #       #
#   #    #      #                                                              #
#   #    #      ######################    ######################################
#   #    #      #                          #              #     #        #     #
#   #    #      #                          #              #     #        #     #
#   #    #      #                          #              #     #        #     #
#   #    #      #                          #        #     #     #        #     #
#   #    #      ##    #################### #        ###   #     #        #     #
#   #    #      #         #                #   #### #     #     #        #     #
#   #    #      #         #                #        #     #     #        #     #
#   #    #      #         #                         #     ###   #              #
#   #    #      #         #                         #     #     #              #
#   #    #      #                                   #     #     #              #
#   #    #      #                                   #     #     #              #
#   #    #      #                                   #           #        #     #
#   #    #      #                                   #           #        #     #
#   #    #      #    ############################## #           #        #     #
#   #    #      #                                   #           #        #     #
#   #    #      #                                   #           #        #     #
#   #    #      #                                   ######      #        #     #
#   #    #      #                            #      #    #      #        #     #
#   #    #      #######    ################# #      #    #      #        #     #
#   #    #      #                            #      #    #      #        #     #
#   #    #      #                            #      #    #               #     #
#   #    #      #                            ##     #        ###         #     #
#   #    #      #                            #      #                    ##    #
#   #    #      #                            #      #                    #     #
#   #    #      #                            #      #           #        #     #
#   #    #      #                                               #        #     #
#   #    #      ############    ############################### #        #     #
#   #    #      #                  #      #     #               #    ### #     #
#   #    #      #                         #     #               #        #     #
#   #    #      #                         #     #               #        #     #
#   #    #      #                         #                     #        #     #
#   #    #      #                                               #        #     #
#        #      #                                               #              #
#        #      ############    ##########                      ##    ##########
#        #      #      #                                        #      #       #
#        #             #                  #                     #              #
#   #    #             #                  ################      #              #
#   #    #             #                  #                     #              #
#   #    #                                #                     #              #
#   #    #      #                         #                     #      #       #
################################################################################
