80 80
################################################################################
#    #    #             #     #     #                                          #
#    #    #             #     #     #                                          #
#    #    #             #     #     #                #                         #
#    #    #   ### #      ##   #     #########    ### #                         #
#    #    #       #           #     #                #####    ##################
##   #    #       #   ##      #     #                #                         #
#    #    #       #           #     #                #                         #
#    #    #       #     #     #     #                #                         #
#         #       #     #     #     #                                          #
#         #       #     #     #     #   ########################################
#         #       #     #           #      #                              #    #
######    #       #     #           #      #                              #    #
#    #    #       #     #           #      #                              #    #
#    #    #       #     #           #                                     #    #
#         #       #     #     #     #                       #        #    #    #
#         ########      #     #     #                       #        #    #    #
#         #       #     #     #     #########    ########## #        #    #    #
#         #       #     #     #     #    #        #         #        #    #    #
#    #    #       #     #     #     #    #        #         #        #    #    #
#    #            #     #           #    #        #         #        #    #    #
#    #            #     #########   #    #                  #        #    #    #
#    #            #     #     #     #    #                  #        #    #    #
#    #     ###          #     #     #    #                  #        #    #    #
#    #    #             #     #     #    #                  #####    #    #    #
#    #    #             #     #     #     #########    #### #        #    #    #
#    #    #             #     #     #                #      #        #    #    #
#    #    #       #     #     #     #                #      #        #    #    #
#    #    #       #     #     #     #                #      #        #    #    #
#                 #     #           #    #                  #        #    #    #
#################    ## #           #    #                  #        #         #
#                       #           #    #                  #        #         #
#                       #           #                                #         #
#                       #     #     #######    ##################### #         #
#           #           #     #     #        #     #                 #    #    #
########    #   ####### ##    #     #        #     #                 #    #    #
#           #           #     #     #        #     #                 #    #    #
#           #           #     #     #              #          #      #    #    #
#           #           #     #     #              #          #      #    #    #
#           #                       #              #########    #### #    ###  #
############    ################### #              #     #     #     #    #    #
#          #      #       #         #        #     #     #     #     #    #    #
#          #      #       #         #        #     #     #     #     #    #    #
#          #      #       #         #        #     #     #     #     #    #    #
#          #      #       #         #        #     #     #     #     #    #    #
#     #    ####           ##    ### #        #     #     #     #     #    #    #
##    #    #                        ######   #     #     #     #     #    #    #
#     #    #                        #        #     #     #     #     #    #    #
#     #    #                        #        #     #     ##    #     #    #    #
#     #    #      #                 #        #     #     #     #     #    #    #
#     #    #      ##########    ### #        #     #     #     #     #    #    #
#     #    #      #       #         #        #     #     #     #     #    #    #
#          #      #       #         #        #     ###   #     #     ###    ####
#    ##### #      #                 #        #     #     #     #     #    #    #
#   #      #      #                 #        #     #           #     #    #    #
#   #      #      #                 #        #     #           #     #    #    #
#   #      #      #                 #        #     #           #     #    #    #
#   #       ###    ################ #        #                 ###   #    #    #
#   #                #       #      #        #           #     #     #    #    #
#   #                #       #      #        #           #     #     #    #    #
#   #                #       #      #        #           #     #     #    #    #
#   #      #         #       #      #        #     #     #     #     #    #    #
#   #      #         ###     #      #        #     #     #     #     #         #
#   #      #         #       #      #        #     #     #     #     #         #
#   #      #         #       #      ######    #### #     #     #     #         #
#   #      #         #       #      #    #    #    #     #           #         #
#   #      #         #       #      #    #    #    #     #           #    #    #
#   #      #         #       #           #         #     #           #    #    #
#   #      #         #       #           #         ####    ####      #    #    #
#   ####   ###    ## #       #           #         #           #     #    #    #
#          #         #                   #         #           #     #    #    #
#          #                        #    #####     #           #     #    #    #
#          #                        #    #         #           #     #    #    #
#          #                        #    #         ###    #    #     #    #    #
#   #      ##    ########### #      #    #         #      #    #     #  * #    #
#   #      #         #       #      #    #         #      #    #     #    #   ##
#   #      #                 #      #    #    #    #      #    #     #    #    #
#   #      #                 #      #         #    #      #    #     #    #    #
#   #      #                 #      #         #    #      #    #     #    #    #
################################################################################
