80 80
################################################################################
#                       #    #         #           #    #             #        #
#                       #    #         #           #    #                      #
#           #           #    #    #    #                                       #
#           #           #    #    #          #                                 #
############    ####### #    #    #          #                                 #
#    #    #      #      #    #    #          #                                 #
#    #    #      #      #    #    #     ##    #### #    #####    ###############
#         #      #           ###    ## #           #    #           #          #
#         #      #           #         #           #    #           #          #
#         #      #           #         #           #    #                      #
#######   #   ###            #         #           #    #                      #
#         #             #    #                     #    #                      #
#                       #    #    ################ #    #                      #
#                       #    #                     #    #                      #
#    #           #      #                          #    #                      #
#    #           #      #                          ###    ######################
#    #           #      #                          #    #     #       #    #   #
##    ########## #      #                          #    #     #       #    #   #
#   #     #      #      #                          #    #     #       #    #   #
#   #     #      #      ############    ########## #    #     #       #    #   #
#   #     #      #      #      #    #         #    #    #     #       #        #
#   #     #      #      #           #         #    #    #     #       #        #
#   #     #      #      #           #         #    #    #     #       #        #
#         #      #      #           #    #         #    #     #       #        #
#         #      #      #           #    #         #    #     #       #    #   #
#         #      #      #      #    #    #         #    #     #       #    #   #
#         #      #      #      #    #    #         #    #     #       #    #   #
#   #     #      #      #      #    #    #    #    #    #     #       #    #   #
#   #     #      #      #      #    #    #    #    #    #     #       #    #   #
#   #     #      #      #      #    #    #    #    #    #     #       #    #   #
#   #     #      #      #      #    #    #         #    #     #       #        #
#   #     #      #      #      #    #    #   ##### #          #        ######  #
#   #     #      #      #      #         #         #          #            #   #
#   #     #      #      #      #         #         #          #            #   #
#   #     #      #      ####    ####     #         #          #            #   #
#   #     #      #      #                #         #    #     #       #    #   #
#   #     #      #      #           #    #    #    #    #     #       #    #   #
#   #     #      #      #           #         #    #    #     #       #    #   #
#   #     #      #      #     #     #######    ### #    #     #       #    #   #
#   #     #      ####   #     #     #        #     #    #     #       #    #   #
#   #     #      #      #     #     #        #     #    #     #       #        #
#         #      #      ##    #     #        #     #    #     #       #        #
######    #      #      #     #     #        #     #    #     #       #        #
#         #      #      #     #     #        #     #    #     #       #        #
#         #      #      #     #     #        #     #    #     #       #    #   #
#                #      #     #     #       *      #    #     #       #    #   #
#                #      #     #     #              #    #     #       #    #   #
#                                                  #          #       #    #   #
#############################################      ######     #       #    #   #
#          #     #          #          #    #      #     #    #       #    #   #
#                #          #          #    #      #     #    #       #    #   #
#                #          #          #    #      #     #    #       #    #   #
#                #          #          #    #      #     #    #       #    #   #
#                #                #    #    #      #     #    #       #    #   #
############     #                #    #    #      #     #    ####    #    #   #
#     #          #   #######      #    #    ####   #     #            #    #   #
#     #          #     #          #    #    #      #     #            #    #   #
#                #          #     #    #    #      #                  #    #   #
#                #          ###    ### #    #      #                  #    #   #
#          #     #          #          #    #      #          #       #    #   #
#          #     #          #          #    #      #          #       #    #   #
#     #    #     #     #    #          #    #      #     #    #            #   #
#     #####      #     #    #          #           #     #    ############    ##
#     #          #                     #           #     #    #    #     #     #
#     #          ###################               #     #    #          #     #
###   #          #                #                #     #    #          #     #
#     #          #                #     #####      #     #    #          #     #
#     #          #                #                #     #    #          #     #
#     #    #     #                #    #           #     #    #          #     #
#     #    #     #                     #           #     #    #          #     #
#     #    #     #                     #           #     #    #######    #     #
#     #    #     #                                 #     #    #     #    #     #
#     #    ###    #############################    #     #    #     #    #     #
#     #    #                                 #     #     #    #     #    #    ##
#     #    #                                 #     #     #    #                #
#     #    #                                       #     #    #                #
#     #    #     #                                 #     #    #                #
#     #    #     #                                 #     #    #                #
################################################################################
