80 80
################################################################################
#   #        #                                               #     #      #    #
#   #        #                                               #     #      #    #
#   #                                                        #     #      #    #
#   #                                                        #     #      #    #
#   #                                                        #     #      ##   #
#   #                                                        #     #      #    #
#   #                                                        #     #      #    #
#   ###########################################    ######### #     #      #    #
#   #      #     #                         #            #    #     #      #    #
#   #      #     #                         #            #    #     #      #    #
#   #            #                         #            #    #     #   ## #    #
#   #            #                         #            #    #     #      #    #
#   #            ############    ######### ###    ##### #    #     #      #    #
#   #####    ### #                   #     #    #       #    #            #    #
#   #       #                        #     #    #       #    #            #    #
#   #       #                        #     #    #       #    #            #    #
#   #       #                              #    #       #    ##    ###### #    #
#   #       #                              #            #    #      #     #    #
#   #            #                         #            #    #      #     #    #
#   #            #                         #            #    #      #     #    #
#   #                                      #        ### #    #      #          #
#   ##############    #################### #    #       #    #      #          #
#   #     #              #    #    #       #    #       #    #      #          #
#   #     #              #    #    #       #    #            #      #          #
#   #     #              #    #    #       #    #            #      ##    #    #
#   #                    #    #    #            #            #      #     #    #
#   #                    #    #                 #            #      #     #    #
#   #                    #    #                              #      #     #    #
#   #    ############### #    #         ### ######    ###### #      #     #    #
#   #       #       #    #    #            #        #        #      #     #    #
#   #       #       #    #    #    #       #        #        #      #     #    #
#   #       #       #    #    #    #       #        #        #            #    #
#   #       #       #    #    #    #       #        #        #            #    #
#   #       #            #         #       #        #        #                 #
#   #       #            #         #       #        #        #########    ######
#   #       #####        #          ###### #        #        #       #         #
#   #       #            #          #      #        #        #       #         #
#   #       #       #    #    #     #      #        #        #       #         #
#   #       #       #    #    #     #      #        #        #       #         #
#   #       #       #    #    #     #      #        #        #       #     #   #
#   #       #       #    #    #            #        #        #       #     #   #
#   #####   #            #    #            #        #        #       #         #
#   #       ####    #####     ###          #        #        #       #   #######
#   #       #                 #            #        #                #         #
#   #       #                 #     #      #        #                #         #
#   #       #                 #     #      #        #                #         #
#   #       #      #     #    #            #        #                #    #    #
#   #       #      #     ###    ########## #        #        ###     #    ###  #
#   #       ####   #     #      #          #        ####     #       #    #    #
#   #       #      #     #                 ###    ##         #            #    #
#   #       #      #     #                 #                 #            #    #
#   #              #     #                 #                 #            #    #
#   #              #     #                 #                 #            #    #
#   #              #     #                 #                 #            #    #
#   #              #                                                           #
#   ##############    ##########################################################
#   #                                 #                           #       #    #
#   #                                 #                           #       # *  #
#   #                                 #                           #            #
#   #                                       #                     #            #
#   #                                       #               #     #            #
#   #                                       #               #     #            #
#   ###################    ################ #                     ##########   #
#                                           #    ################ #       #    #
#                                           #     #               #       #    #
#                                           #     #               #       #    #
#                                           #                     #       #    #
#   #                                       #                     #       #    #
#   #                                                             #       #    #
#   ################################################    ######### #       #    #
#   #                          #                                      ### ###  #
#   #                          #                                          #    #
#   #                          #                                               #
#   #                                                                          #
#   #                                                             #            #
#   #                                                             #            #
#   #                                                             #       #    #
#   #                          #                                  #       #    #
################################################################################
