80 80
################################################################################
#     #         #           #                     #    #               #       #
#     #         #           #                     #                    #       #
#               #      #    #        #            #           #        #       #
#          #    #      #    #        #            #           #        #       #
#          #    #      #    #        #            #           #        #       #
#          #    #      #    #        #            #    #      #        #       #
#     #    #    #      #             #            #    #      #        #       #
#     #    #    #                                 #           #        #       #
#     #    #    #   ########    ################# #    ###### #        #       #
#     #    #    #    #           #          #     #     #     #        #       #
#     #    #         #      #    #                #     #     #        #       #
#     #    #         #      #    #                #     #     #        #       #
#     #    #         #      #                     #     #     #        #       #
#     #    #         #      #          #          #     #     #        #       #
#     #         #    #      #          #    #     #     #     #        #   #####
#     ######    #    #      ########   #    #     #     #     #        #       #
#     #         #    #      #          ###    ### #     #     #        #       #
#     #         #    #      #          #          #     #     #        #       #
#     #         #    #   ## #          #          #     #     #        #       #
#     #    #    #    #      #          #          ##    #     #        #       #
#     #    #    #           #    #     #          #     #     #        #       #
#     #    #    #           #    #     #          #     #     #        #       #
#     #    #    #                      #          #     #     #        #       #
#     #    #    #######################    ###### #     #     #        #       #
#     #    #    #                                 #           #        #       #
#     #    #    #                                 #           #        #       #
#     #    #    #                                 #           #        #       #
#     #    #    #                                 #           #    ### #       #
#     #                                           #     #     #        #       #
#     #######################################     #     ###   #        #       #
#     #                          #     #     #    #     #     #        #       #
#     #                                #     #    #     #     #        #       #
#     #                                #     #    #     #     #        #       #
#     #     #                          #     #    #     #     #        #       #
#     #     #                          #     #    #     #     #        #       #
#     #     #                    #     #     #    #     #     #        #       #
#     #     #                    #     #     #    #     #     #        #       #
#     #     #                    #     #          #     #     #        #       #
#     #                          #     #          #     #     #        #       #
#     ######################     #     #          #     #     #        #       #
#     #       #         #        #     ###        #     #     #        #       #
#     #       #         #        #     #     #    #     #     #        #   *   #
#     #       #         #        #     #     #    #     #     #        #       #
#     #       #                  #     #     #    #     #     #        #       #
#     #                          #     #     #    #     #     #        #       #
#     #                          #     #     #    #     #     #                #
#     ####     #####    ######## #     ######     #     #     #                #
#     #                          #     #          #     #     #                #
#     #       #                  #                #     #     #                #
#     #       #                  #                      #     #############    #
#     #                          #                      #     #       #    #   #
#     ###########################    ##                 #     #       #    #   #
#     #                                #     #          #     #       #    #   #
#     #                                #     #    #     #     #       #    #   #
#     #                                #     #    #     #     #       #        #
#     #                                                 #     #       #        #
#     ##################################################      #       #        #
#     #             #                              #          #       #####    #
#     #             #                              #          #       #    #   #
#     #             #                                         #       #    #   #
#     #        #    #                                         #       #    #   #
#     #        #    #                                         #    ## #    #   #
#     #        #    #                                         #       #    #   #
#     ######   #    #                                         #       #    #   #
#     #        #    #                                         #            #   #
#     #        #    ######################################    #            #   #
#     #        #    #                            #            #            #   #
#     #        #    #                            #            #            #   #
#     #######    ###                             #            #       #    #   #
#     #                                          #            #       #    #   #
#     #                                          #            #       #    #   #
#     #                                                       #       #    #   #
#     #                                                       #       #    #   #
#                                                             #       #    #   #
###############################################    ########## #       #    #   #
#                                                             #       #        #
#                                                             #       #        #
#                                                             #       #        #
################################################################################
