80 80
################################################################################
#      #     #           #             #     #             #            #      #
#      #     #           #             #     #             #            #      #
#      #     #     #     #             #     #                          #      #
#      #     #     #     #             #     #                          #      #
#      #     #     #     ###    ###### ##    #                          #      #
#      #     #     #     #     #       #     ##################    #####       #
#      #     ####    ### #     #       #     #                                 #
#      #     #           #     #       #     #                                 #
#      ##    #           #     #       #                                       #
#                        ##    #       #                                #      #
#                        #     #       #                          #     #      #
#                        #     #       #                          #     #      #
#                        #     #       #                          #     #      #
#      ##    ########### #     #       #                          #     #      #
#      #            #    #     #       #########################    ### #      #
#   ## #            #    #     #       #                                #      #
#      #                 #     ###    ##                                #      #
#      #                 #                                              #      #
#      #####   #         #                                              #      #
#      #       #   ##### #                                              #      #
#      #       #    #    #                                              #      #
#      #       #         ##########################################     #      #
#      #       #         #                                    #         #      #
#      #       #         #                                    #         #      #
#      #       #         #                                              #####  #
#                        #                                              #      #
##    ################## #########################    ######## ######   #      #
#                        #                                              #      #
#                        #                                    #         #      #
#                        #                                    #         #      #
#                        #                                                     #
#           #       #    ########################################    ###########
#           #       #    #                      #           #    #             #
#                   #    #                      #           #    #             #
#    ############## #                                       #    #             #
#       #      #    #                                       #    #             #
#       #      #    #     ############    ######     ###### #    ##########    #
#       #           #                #                #     #    #        #    #
#       #           #    #           #          #     #     #    #        #    #
#       #           #    #           #          #     #     #    #        #    #
#       #    ##     #    #      #               #     #     #    #        #    #
#       #      #    #    #      #               #     #     #    #        #    #
#       #      #    #    #      #         ##### #     #     #    #        #    #
#       #      #    #    #####    ###      #    #           #    #        #    #
#       #      #    #    #           #     #    #           #    #        #    #
#       #      #    #    #           #          #           #    ###      #    #
#       #      #    #    #           #          #           #    #        #    #
#       #      #    #    #                            #     #    #        #    #
#       #      #    #    #########################    ##### #    #        #    #
#       #      #    #    #    #      #       #    #    #    #    #        #    #
#       #      #    #    #    #      #       #    #    #    #    #        #    #
#       #      #    #    #    #              #    #         #    #        #    #
#       #      #    #    #    #              #    #         #    #        #    #
#       #      #    #    #    #              #              #    #        #    #
#       #      #    #    #    #              #              #             #    #
#       #      #    #    #    #      #       #     ####    ##             #    #
#       #      #    #    #    #      #       #                            #    #
#       #      #    #    #    #      ####    #    #                       #   ##
#              #    #    #    #      #       #    #              #             #
#              #    #    #    ###    #       #    #              #             #
#              #    #    #    #      #       #*   #         #    #             #
#####          #    #    #           #       #####    ##### #    #             #
#       #      #    #    #           #       #      #       #    #        #    #
#       #      #    #    #           #       #      #       #    #        #    #
#       #      #    #    #           #                      #    #        #    #
#       #      #    #    #    #                             #    #        #    #
#       ####    ### #    #    ###########                ## #    #        #    #
#       #           #    #    #                             #    #        #    #
#       #           #    #    #              #      #       #             #    #
#       #           #    #    #              #      #       ##############    ##
#       #           #    #                   #      #       #                  #
#       #     #     #    ###########    #### #      #       #                  #
#       #     #     #    #                   #      #       #                  #
#       ###   ##    #    #                   #      #       #                  #
#       #     #     #    #                   ##     #       #    ###### ###    #
#       #     #     #    #                   #      #       #           #      #
#       #     #     #    #       #           #      #       #           #      #
#       #     #     #    #       #           #      #       #           #      #
################################################################################
