80 80
################################################################################
#             #        #                 #           #      #              #   #
#                      #                 #           #      #              #   #
#                      #                 #           #      #       #      #   #
#                      #                 #           #      ####    ####   #   #
#                      #####    ######## #     #     #      #       #      #   #
###############    ### #                 #     #     #      #       #      #   #
#    #                 #                 #     #     #      #       #      #   #
#    #                 #                 #     #     #      #              #   #
#    #                 #                 #     #     #      #########      #   #
#    #                  ###    ### #     #     #     ###    #       #      #   #
#    #   ##############       #    #     #     #     #      #       #      #   #
#    #           #            #    #     #     #     #      #              #   #
#    #           #            #    #     #     #            #              #   #
#                #     #      #    #     #     #            #              #   #
#                #     #   ###     #     #     #            #              #   #
#  ##      ###### ##   #           #     ####    ####       ##      #          #
#                      #           #     #      #    #      #       #          #
#    #                 #           #     #      #    #      #       #          #
#    #                 #           #            #    #      #       #          #
#                                               #    #      #              #   #
######################################               #      ################   #
#                #      #       #                    #      #        #    #    #
#                #      #                #           #      #        #    #    #
#                       #                #                  #        #    #    #
#                       #                ##    ############ #        #    #    #
#                       #                #                  #        #         #
##############    ##### ######    ###### #                  #        #         #
#                                        #                  #        #         #
#                                        #                  #    ### #####    ##
#                                        #    #             #        #    #    #
#                                        #    #             #        #    #    #
#                                        #    #             #        #    #    #
#                                             #             #        #    #    #
###########################################    ############ #        #    #    #
#                  #      #          #    #        #        #        #    #    #
#                                         #        #        #        #    #    #
#                                         #        #        #        #    #    #
#                                         #        #        #        #    #    #
#                                         #    ### #        #        #    #    #
#   ##################### #               #        #        #        #    #    #
#             #           ##    ######### #        #        #        #    #    #
#             #           #      #        #        #        #        #    #    #
#                         #               #        ####     #        #    #    #
#                         #               #        #        #        #    #    #
#                         #               #                 #        #    #    #
#                                         #                          #    #    #
#####################################     #                          #    #    #
#                                   #     #                          #    ##   #
#                                   #     #        #                 #    #    #
#                                   #     #        #        #        #    #    #
#                                   #     #########    #### #        #    #    #
#                                   #     #          #      #        #    #    #
#####################    ########## #     #          #      #        #    #    #
#     #                       #     #     #          #      #        #    #    #
#     #                             #     #    #     #      #        #    #    #
#     #                                   #    #     ####   #        #    #    #
#     #                                        #     #      #        #    #    #
#     #      #                                 #     #      #        #    #    #
#     #      #                #                #     #      #        #    #    #
#     #      #                #     #          #     #      #        #    #    #
#     #                       #     #     #    #     #      #             #    #
#     #############    ###### #     #     #    #     #      #             #    #
#     #                       #     ##    #    #     #      #                  #
#     #                       #     #     #    #     #      #                  #
#     #                       #     #     #    ###          #        #         #
#     #          #            #     #     #    #            #        #         #
#     #          #            #     #     #    #            #        #    #    #
###   #          #                  #     #    #            #        #    #    #
#     ########    ################# #     #    #     #      #        #    #    #
#     #           #    #            #     #    #     #      #        #    #    #
#     #                #        *   #     #    #     #      #        #    #    #
#                      #            #     #    #     #      #        #    #    #
#                      #            #     #    #            #        #    #    #
#                      ##    ###### #     #    #######      #        #    #    #
#      #########    ## #            #     #    #      #     #        #    #    #
#     #                #            #     #    #      #     #        #    #    #
#     #                             #     #    #            #        #    #    #
#     #                             #     #    #            #        #    #    #
################################################################################
