80 80
################################################################################
#                #    #     #     #         #    #                             #
#                     #     #     #         #    #                             #
#                           #     #         #                       #          #
##    ###########           #     #         #                       #          #
#      #    #               #     #    #    #                       #          #
#      #    #    #          #     #    #    #                       #          #
#      #    #    #    #     #          #    #    #                  #          #
#      #         #    #     #          #    #    #################    ##########
#      #         #    #     #          #         #       #        #            #
#      #         #    #     #          #         #                #            #
#      #         #    #     #     #    #         #                #            #
#      #         #    #     #     #    #         #                #            #
##     #         #    #     #     #    #    #    #                #      #     #
#      #######   #    #     #     #    #    #    #####   #        ###    ####  #
#      #    #    #    #     #     #    #    #    #       #   #### #      #     #
#      #    #    #    #     #     #    #    #    #       #        #      #     #
#      #    #    #    #     #     #    #    #    #       #        #      #     #
#      #    #    #    #     #     #    #    #    #       #        #      #     #
#      #    #    #    #     #     #    #    #    #       #        #######    ###
#      #    #    #    #     #     #    #    #    #       #        #     #      #
#      #    #    #    #     #     #    #         #       #        #     #      #
#      #    #    #          #     #    #   ##### #       #        #     #      #
#      #    #    #######    #     #    #    #    #                #     #      #
#      #    #    #     #    #     #    #    #    ###########      #     #      #
#      #    #    #     #    #     #    #    #    #    #    #      #     #      #
#      #    #    #     #    #     #    #    #    #         #      #     #      #
#      #    #    #     #          #    #         #         #      #     #      #
#      #    #    #     #          #    #         #         #      #     #      #
#      #    #    #     #          #    #         #                #      ###   #
#      #    #    #     #          #    #         #                #            #
#      #    #    #     #    #     #    #    #    ##    ####       #            #
#      #    #    ###        #     #    #    #    #                #            #
#      #    #    #          #     #    #    #    #         #            #      #
#                #          #     #    #    #    #         #            #      #
#                #          #          #    #    #    #    #            #      #
#                #          #    ##### #              #                        #
#################    ###### #          ###############    ######################
#                           #          #        #              #         #     #
#                           #          #        #              #         #     #
#                           #          #        #              #         #     #
#                                      #        #        #     #         #     #
##################    ################ #                 #     #    #####      #
#                           #     #    #                       #               #
#                           #     #    #         ##    ####### #               #
#                           #     #    #             #         #               #
#         #                 #     #    #        #    #                   #     #
#         #                 #     #    #        #    #              #    #     #
#                           #     #    #        #    #              #    #     #
######    ################# #          #        #          ####     #    #    ##
#    #     #      #    #    #          #        #              #    #    #     #
#    #            #         #          #        #              #    #    #     #
#    #            #         #          #        #              #*   #    #     #
#    #            #         #     #    #        #                        #     #
#    #            #         #     #    #        #####################    #     #
#     ###    #### #         #     #    #        #        #               #     #
#          #      #         #     #    #        #        #               #     #
#          #      #    #### #     #    #        #                        #     #
#                 #         #     #    #        #                        #     #
#    #                      #     #    #        #                              #
#    #                      #     #    #        #############################  #
#    #                      #     #    #        #      #      #    #     #     #
#    ###########    ####### #     #    #        #             #          #     #
#    #    #                 #     #    #        #             #          #     #
#    #    #                 #          ###      #             #          #     #
#    #    #                 ##    #### #        ###           #          #     #
#    #    #            #    #     #    #        #      #      #    #           #
#    #    #            #    #     #    #        #      #      #    #           #
#    #    #            #    #     #    #        #      #       ####    ##      #
#    #    #            #    #     #    #        #                  #           #
#    #    ##########    ### #     #    #        ##########         #     #     #
#    #    #                       #    #        #                  #     #     #
#    #                            #    #        #             #          #     #
##   #                            #    #        #             #          ####  #
#    #                       ##        #        #                        #     #
#    #         ##########   #          #        #####    ############### #     #
#    #    #     #           #          #        #                        #     #
#    #    #     #           #          #        #                        #     #
#    #    #     #           #     #    #        #                        #     #
################################################################################
