80 80
################################################################################
#    #    #      #        #                     #       #         #       #    #
#    #           #        #                     #       #         #       #    #
#    #           #        #                     #       #         #            #
#    #                    ######   #######      #       ####      #            #
#    #                    #        #            #####   #         #            #
#    #    ###             #        #            #       #         #            #
#    #    #               #        #            #       #         #       #    #
#    #    #      #        #                     #                 #       #    #
#    #    #      #        #####    ############ #                 #       #    #
#    #    #      #   #### #                     #                 #       #    #
#    #    #      #                              #                 #       #    #
#    #    #      #                              ############      #       #    #
#    #    #      #                              #      #     #    #       #    #
#    #    #      #                              #      #     #    #       #    #
#         #      ####################    ###### #      #     #    #       #    #
#         #      #     #       #       #        #      #     #    #       #    #
#         #      #     #       #       #        #           ##    ###     #    #
#         #      #     #               #        #                 #       #    #
#    #    #      #     #               #        #                 #       #    #
#    #    #      #     #               #        #                 #       #    #
#    #    #      #     #               #        #      #          #       #   ##
#    #    #      #     #       #       #        #      #     #    #       #    #
#    ##    ##### #     #       #       #        #      #     #    #       #    #
#    #     #     #     #       #       #        #      #     #    #       #    #
#    #     #     #     #       ####    #               #     #    #       #    #
#    #     #     #     #       #       #               #     #    #       #    #
#    #           #     #    ## #       #               #     #    #       #    #
##   #           #     #       #       #               #     #    #            #
#    #           #     #       #       #        #      #          ###    #######
#    #           #     #       #       #        #      #######    #            #
#    #           #     #       #       #        #      #          #            #
#    #           #     #               #        #      #          #            #
#####    ####### #     ##    ######### #        #      #                 #     #
#      #    #    #     #               #        #      #    #      ##    ##    #
#      #    #    #     #               #        #      #    #            #     #
#      #    #    #     #               #        #      #    #            #     #
#      #         #     #          #    #   #### #      #    #            #     #
#      #         #     #     #    #    #        #                              #
#      #         #     #     #    #    #        ####################    ########
#      #         ###   #     #    #    #        #        #       #     #       #
#      #    #    #     #     #    #    #        #        #       #     #       #
#      #    #    #     #     #    #    #        #        #       #     #       #
#      #    #    #     #     #    #    #        #        #       #     #       #
#      #    #    #     #     #    #    #        #        #       #     #       #
#      #    #    #     ##    # *  #    #        #        #       #     ##    ###
#      #    #    #     #     #    #    #        #        #       #             #
#      #    #    #     #     ###    ## #        #        #                     #
#      #    #    #     #     #         #        #        #                     #
#      #         #     #     #         #        #        #                     #
#      #    #### #     #     #         #        #        #             #       #
#      #         #           #         #        #        #       #     #       #
#      #         #           #         #        #        #       #     #       #
#      #         #           #         #        #        #       #     #       #
#      #         ###########    #######         #        #       #     #       #
#           #    #         #                    #        #       #     #       #
#           #    #         #                    #        #####   #     #       #
#           #    #         #                    #        #       #     #       #
#           #    #    #    #    #      #        #        #       #     #       #
#      #    #    #    #    #    ##     #        ####     #       #             #
#      #    #    #    #    #    #      #        #        #       #######    ####
#      #    #    #    #    #    #      #        #        #       #    #        #
#      #    #    #    #    #    #      #        #        #       #    #        #
####   #    #    #         #    #      #        #        #       #    #        #
#      #    #    ######    #####    ## #        #        #       #    #        #
#      #    #    #                     #        #        #       #             #
#      #    #    #                     #        #        #       #             #
#      #    #    #                     #        #                #             #
#                                               #                              #
#################################    ########## #         ##############    ####
#                                      #        #                   #          #
#                                      #        #        #          #          #
#                                      #        #        #                     #
#                                      #        #        #                     #
#############    ###################### ###     #        ####    ###           #
#   #                                           #        #           ########  #
#                                               #        #          #          #
#                                               #        #          #          #
#                                      #        #        #     #    #          #
################################################################################
