80 80
################################################################################
#   #      #       #     #       #        #        #     #    #      #     #   #
#   #      #       #     #       #        #        #     #    #      #     #   #
#          #       #     #       #        #        #     #    #            #   #
#          #    ## ###   #####   #        #        #     #    #            #   #
#          #       #             #        #        ##         ##           #   #
#          #       #             #        #        #          #            #   #
#   #      #       #             ####     #        #                 #     #   #
#####    ##        #             #        #        #                 #     #   #
#   #              ########    ##         #        #     #           #     #   #
#   #              #    #                 #        #     #           #         #
#   #              #    #                 #        #          #      #         #
#   #      #       #    #                 #        ########   #      #         #
#   #      #       #    #        #        #    ### #    #     #      #         #
#   #      #       #     ###     #        #        #    #     #      #     #   #
#          #       #             #        #        #    #     #      ##    #   #
#          #       #             #        #        #    #     #      #     #   #
#          #       #             #        #        #    #     #      #     #   #
#          #       #                      #        #    #     #      #     #   #
#   #      #       ##########    ######## #        #    #     #            #   #
#   #      #       #        #             #        #    #     #   ######## #   #
#   #      #       #        #             #        #    #     #     #      #   #
#   #      #       #                      #             #     #     #      #   #
#                  #                      #             #     #     #      #   #
#############      #               #      #             #     #     #      #   #
#        #         ##########      ##     #             #     #      ###   #   #
#        #         #       #       #      #        #    #     #            #   #
#        #         #       #       #      #        #          #            #   #
#        #         #               #               #          #            #   #
#        #         #               #               #          #     #      #   #
####     #         #               #               #          #     #      #   #
#   #    #         ################    ########### #          #            #   #
#   #    #         #                      #        ########    ########### #   #
#   #    #         #                      #        #                       #   #
#   #    #         #                      #        #                       #   #
#   #    #         #                      #        #                       #   #
#   #    #         #        #                      #                           #
#   #    #         #        #                      #   #########################
#   #    #         #        #                      #    #     #       #    #   #
#   #              #        #                      #    #             #    #   #
#   #              ###      ################    ## #                  #        #
#   #     ###      #        #     #    #           #                  #        #
#   #              #        #     #    #           #                  #        #
#   #    #         #        #     #    #           #          #       #        #
#   #    #         #        #     #    #           #    #     #       ##    ####
#   #    #         #        ##    #    #    #      #    ###    ###### #    #   #
#   #    #         #        #          #    #      #    #       #     #    #   #
#   #    #                  #          #    #      #    #       #     #    #   #
#   #    #                  #          #    #      #    #       #     #    #   #
#   #    #                  #          #    #      #    #       #     #    #   #
#   #    #                  #   #######     #      #    #       #     #    #   #
#   #    #         #        #               #      #    #   ### ###   #    #   #
#   #    #         #        #               #      #    #       #          #   #
#   #    #         #        #               #      #    #       #        * #   #
#   #    #         #        #    #     ##    ##### #    #       #          #   #
#   #    #         #        #    #     #    #      #    #                  #   #
#   #    #         #        #    #     #    #      #    #             #    #   #
#   #    #         #        #    #     #           #                  #    #   #
#   #    #         #        #    #     #           #   ############## #    #   #
#   #    #         #        #    ###   #           #                  #    #   #
#   #    #         #        #    #     #           #                  #    #   #
#   #    #         #        #    #     #    #      #                  #    #   #
#   #    #         #        #    #     #    #      #     #            #        #
#   #    #         #        #    #     #    #      #     #            #        #
#   #    #         #                                                           #
#   #    #         ###    ######################################################
#   #    #         #         #                                                 #
#   #    #         #                                                           #
#   #    #         #                                                           #
#   #    #         #                                                           #
#   #    #         #                                                  #   ######
#        #         #                                                  #    #   #
#        #         ####################    ########################## #        #
#        #         #                                                  #        #
#        #         #                                                  #        #
#   #    #         #                                                  #        #
#   #    #         #                                                  #    #   #
#   #    #         #                       #                          #    #   #
#   #    #         #                       #                          #    #   #
################################################################################
