80 80
################################################################################
#   #                       #      #            #                      #       #
#                                  #            #                      #       #
#                  #               #            #                      #       #
#                  #               ######    ## #################      #       #
#####    ######### #                            #        #      #              #
#                  #                            #        #      #              #
#                  ###########                  #        #      #           ####
#                  #                            #        #      #              #
#         #        #               #            #        ##     #      #       #
#         #        #               #       #    ####            #   ## #       #
#                                  #       #    #               #      #       #
###############################    #       #    #                      #       #
#                                  #       #    #                      #       #
#                                  #       #    #        #             #       #
#                                  ####    #    #        #             #       #
#              #                   #       #    #        #             #       #
############   ############    ### #       #    #        #             #       #
#              #                   #       #    #        ########      #       #
#              #                   #       #    #        #             #       #
#              #                   #       #    #        #             #       #
#                                               #        #             #       #
#####################    ###################### #                              #
#       #    #      #        #     #     #      ##########################    ##
#       #    #      #        #     #            #         #        #     #     #
#       #    #      #        #     #            #         #        #     #     #
#            #      #        #     #            #         #        #     #     #
#            #      #        ##     ##          #    #    #        #     #     #
#            #      #        #           #      #    #    #        #     #     #
#            #      #        #           #      #         #   #### #     #     #
#       #    ####   #        #           #      #    #### #        ###   #     #
#       #    #      #        #     #     #      #    #    #        #     #     #
#       #    #      #        #######     ####   #    #             #     #     #
#       #    #      #        #           #      #    #             #     #     #
#       #    #      #        #           #      #                  #     #     #
#       #    #      #        #           #      #                  #         ###
#       #    #      #        #    #      #      #                  #           #
#       #    #      #        #    #      #      #                  #           #
#       #           #        #    #      #      ######    ######## #           #
#   ### #           #        #                  #    #     #       #           #
#       #           #        ###############    #    #     #       #           #
#       #           #        #      #    #      #    #     #       #########   #
#       #           #        #      #    #      #    #     #       #     #     #
#       #####    ## #        #      #    #      #    #     #       #     #     #
#       #    #      #        #      #    #      #          #       #     #     #
#       #    #      #    ### ####        #      #          #       #     #     #
#       #           #        #           #      #          #       #     #     #
#       #           #        #                  #          #       #     #     #
#                   #        #                  #    #     #       #     #     #
###########    #### #        #                  #    #     #       #     #     #
#        #    #     #        #    #######            #     #       #     #     #
#        #    #     #        #           #           #     #       #     #     #
#        #    #     #        #           ####    ####      #       #           #
#        #    #     #                    #           #     #       #           #
#        #    #     #             #      #      #    #     #       ##          #
#        #          #             #      #      #    #     #       #           #
#        #          #                           #    #     #       #     #     #
#        #          ###    #################### #    #     #       #     #     #
###      #####      #               #    #      #    ###   #       #     ####  #
#        #    #     #               #           #    #     #       #     #     #
#        #    #     #               #           #    #     #       #     #     #
#             #     #       #       #           #    #     #       #     #     #
#             #             #   ### #           #    #     #       #     #     #
#             #      ##     #       #    #      #    #     #       #     #     #
#             #             #       #    #      #    #     #       #     #     #
#        #    #             #       #    #      #    #     #       #     #     #
#        #    #     #       #       #    ####   #    #     #       #     #     #
#        #    #     #       #            #      #    #     #       #     #     #
#        #          #       #            #      #    #     #       #     #     #
#        #          #       #            #      #    #     ###     #     #     #
#        #     ##   #                    #      #    #     #       #     #     #
#        #          ###    ######## #    #      #    #     #       #     #     #
#        #    #     #       #       #    #      #    #     #       #     #     #
#        #    #     #       #       #           #    #     #             #     #
#        #    #     #               ########    #    #     #             #     #
#        #    #     #               #           #                        #     #
#        #    #     #               #           #                        #     #
#        #    #     #               #           #                  #     #     #
#        #    #     #      *#       #     #     #                  #     #     #
################################################################################
