80 80
################################################################################
#    #     #                             #              #                #     #
#    #     #                             #              #                #     #
#    #     #                                            #    #    #      #     #
#    #     #                                                 #    #      #     #
#    #     #                                                 #           #     #
#    #     ###    ######################################     #######           #
#    #     #       #                      #     #            #      #          #
#    #     #       #                      #     #       #    #      #          #
#    #     #                              #     #       #    #      #          #
#    #     #                              #             #    #           #     #
#    #     #        ##################    #             #    #           #     #
#    #     #              #               #             #    #           #     #
#    #     #    ## #      #                ##########   #    #           #     #
#    #     #       #      #                             #    #           #     #
#    #     #       #                                    #                #     #
#    #     #       #                                    #######    ##### #     #
#    #     #       #                                    #      #         #     #
#    #     #       ##############    ################## #      #         #     #
#    #     #       #                          #         #      #         #     #
#    #     #       #                          #         #                #     #
#    #     #       #                          #         #                #     #
#    #     #       #                                    #                #     #
#    #     #       #                                    #                #     #
#    #     #                                                             #     #
#    #     ###########################    ############################## #    ##
#    #     #                *                                            #     #
#    #     #                                                             #     #
#    #     #                                                             #     #
#    #     #                                                                   #
#    #     ####################    #############################################
#    #     #    #      #                                                  #    #
#    #     #    #      #                                                  #    #
#    #     #    #      #                                                  #    #
#    #     #           #                                                  #    #
#    #     #           #############    ############################ #         #
#    #     #           #                  #                          #         #
#    #     #           #                  #                          #         #
#    #          #      #                  #                          ###    ####
#    #      #####      #                  #                          #         #
#    #          #      #                                             #         #
#    #          #      #                                             #         #
#          #    #      #                                                       #
#          #    #      #    ####################################################
#          #    #      #    #     #                                      #     #
#          #    #      #                                                 #     #
#    #     #           #                                                 #     #
#    #     #           #                                                 #     #
#    #     #           #                                                 #     #
#    #     #           #    ##### ##############    #################### #     #
#    #     #    #                 #           #                          #     #
#    #     #    #                 #                                      #     #
#    #     #    #                 #                                      #     #
#    #     #    #                 #                                      #     #
#    #     #    #      #     #    #                                      #     #
#    #     #    #      #     #    #                                      #     #
#    #     #    #      #          #                                      #     #
#    #     #    #      #########    #################################### #     #
#    #     #    #      #                        #     #       #     #    #     #
#    #     #    #      #                              #                  #     #
#    #     #    #      #                                                 #     #
#    #     #    #      #      #                                          #     #
#    #     #    #      #   ## #         #                                #     #
#    #     #    #      #      #         ########    ##    ######### #    #     #
#    #     #    #      #      #         #             #        #    #    #     #
#    #     #    #      #      ####      #             #        #    #    #     #
#    #     #    #      #      #         #             #             #    #     #
#####      #    #      #      #         #       #     #             #    #     #
#    #     #    #      #      #         #       #     #             #    #     #
#    #     #    #      #      #         #             #             #    #     #
#    #     #    #      #      #         ###########    ############ #          #
#          #    #      #      #         #                           #          #
#          #    #      #                #                           #          #
#          #    #      ############     #                           #          #
#          #    #      #        #       #                                #     #
#    #     #    #      #        #       #################    ########### #     #
#    #     #    #      #        #       #                                #     #
#    #     #    #      #                #                                #     #
#    #     #    #      #                #                                #     #
################################################################################
