80 80
################################################################################
#                                      #            #              #           #
#                                      #            #                          #
#                                      #    #       #                          #
#                                      #    #####   #                          #
#                                      #    #       ########################   #
#    ##################################     #       #         #                #
#   #     #     #      #    #     #         #       #         #                #
#   #     #     #      #    #     #         #                 #                #
#   #     #     #      #    #     #         #                 #                #
#   #     #     #      #    #     #    #             #####        ##############
#   #     #     #      #    #     #    #   #########                           #
#   #     ###   #      #    #     #    #            #                          #
#   #     #     #           #     #    #            #                          #
#   #     #     #           #     #    #            #                          #
#   #     #     #           #     #    #                                       #
#   #     #     #           #     #    ######    ###############################
#   #     #     #      #    #     #    #          #       #            #       #
#   #     #     #      #          #    #          #       #            #       #
#   #     #     #      #               #          #       #            #       #
#   #     #     #      #               #          #       #            #       #
#   #     #     #      #               #          ###     #            #       #
#   #     #     ##     #    #          #          #       #                    #
#   #           #      #    #     #    ###    ####        #                    #
#   #           #      #    #     #    #                  #                    #
#   #           #      #    #     #    #                  ######    ############
#   #           #      #    #     #    #                  #       #        #   #
#   #     #     #      #    #     #    #    #             #       #        #   #
#   #     #     #####    ## #     #    #    #             #       #        #   #
#   #     #     #    #      #     #    ##    ############ #       #        #   #
#   #     #     #    #      #     #    #     #       #    #       #        #   #
#   #     #     #    #      #     #    #     #       #    #       #        #   #
#   ####    ### #           #     #    #     #       #            #        #   #
#   #     #     #           #    *#    #     #       #            #        #   #
#   #     #     #           #     #    #     #       #            #        #   #
#   #     #     #           #          #     #       #            #        #   #
#   #     #     #    #      ########   #     #       #    #       #            #
#   #     #     #    #      #          #     #       #    #                    #
#   #     #     #    #      #          #     #       #    #                    #
#   #     #     #    #      #          #     #       #    #                    #
#   #     #     #                      #             #    #                #   #
#   #     #     ###################    #             #    #       #        #   #
#   #     #     #      #       #       #         ### #    #       #        #   #
#   #     #     #      #       #       ###           #    #       ######   #   #
#   #     #     #      #       #       #     #       #    #       #        #   #
#   #           #      #       #       #     #       #    #       #        #   #
#   #           #      #       #       #     #       #    #       #        #   #
#   #           #      #       #       #     #       #    #       #            #
#   #           #      #       #       #     #            #       #   ##########
#   #     #     #      #       #       #     #            #       #       #    #
#   #     #     #      #       #       #     #            #       #       #    #
#   #     #     #      #       #       ###    #######     #       #       #    #
#   #     #     #      #####   #       #       #     #    #       #       #    #
#   #     #     #      #       #       #       #     #    #       #       #    #
#   #     #     #      #               #       #     #    #       #       #    #
#         #     #      #               #       #     #    #       #       #    #
#         #     #    ##                #       #     #    #       #       #    #
#         #     #                      #       #     #    #       #       #    #
#         #     #              #       #       #     #    #       #       #    #
#   #     #     #              #       #       #     #    #       #       #    #
#   #     #     #      #       #       #       #     #    #       #       #    #
#   #           #      #       #       #       #     #    #       #       #    #
##    ######### #      #       #       #       #     #    #       #       #    #
#                      #       #       ##    ##      #    #       #       #    #
#                      #       #       #             #    #       #       #    #
#                      #       #       #             #    #       #       #    #
#     #                #       #       #             #    #       #       #    #
#  ## #    #    #      #       #       #       #     #    #       #       #    #
#     #    #    #      #       #       #       #     #    #   ### #       #    #
#     #    #    #####    ##### #       #       #     #    #       #       #    #
#     #    #    #    #         #       #       #     #    #       #       #    #
#     #    #    #    #         #       #       #     #    #       #       #    #
#     #    #    #    #         #       #       #     #    #       #       #    #
#     #         #              #    ## #       #     #    #       ##      #    #
#     #   ##### #              #       #       #     #    #       #            #
#     #    #    #        ##### #       #       #     #    #       #            #
#     #         #              #       #       #     #    #       #            #
#     #         #    #         #       #       #     #    #       #            #
#     #         #    #         #       #       #     #    #       #       #    #
################################################################################
