80 80
################################################################################
#                                                                     #        #
#                                                                     #        #
#                                                                     #        #
#                                                                     #    #   #
###################    ############################################## #    #   #
#      #     #    #      #    #          #     #    #          #      #        #
#      #     #    #      #    #          #     #    #          #      ######   #
#      #     #    #      #    #          #     #    #          #      #    #   #
#      #     #           #    #          #     #    #          #      #    #   #
#      #     #           #    #     #    ##    #    #####      #      #    #   #
#      #     #         ##     #     #    #     #    #    #     ####   #    #   #
#      #                      ###   #    #     #    #    #     #      #    #   #
#      #          #           #     #    #     #    #    #     #      #    #   #
#      #          #           #     #    #     #    #    #     #      #    #   #
#      #          #           #     #    #     #    #    #     #      #    #   #
#      #     #    #######     #     #    #     #    #    #     #      #        #
#      #     #    #           #     #    #     #    #    #     #      #        #
#      #     #    #           #          #     #    #    #     #      #        #
#      #     #    #           #    ##### #     #    #    #     #      #        #
#      #     #    #           #          #     #    #    #     #      #    #   #
#      #     #    #    #      #                #    #    #     #      #    #   #
#      #     #    #    #                       #    #    ###   #      #    #   #
#      ##    #    #    #                       #    #    #     #      #    #   #
#      #     #    #    #                       #    #    #     #      #    #   #
#      #     #    ###    ############### #     #    #    #     #      #    #   #
#      #     #    #                 #    #     #    #    #            #    #   #
#      #     #    #                      #     #         #            #    #   #
#            #    #                      #               #            #    #   #
#            #    #                      #               #            #    #   #
#       #####     #        #             #               #     #      #    #   #
#            #    #        #        #    #          #    #     #      #    #   #
#      #     #    #        #        #    #     #    #    #     #      #    #   #
#      #     #    #    ### #        #    #     #    #          #      #    #   #
#      #          #        #        #    #          #          #      #    #   #
#      #          #        ######    ### #######    #          #      #    #   #
#      #          #        #             #    #     #          #      #    #   #
#      #          #        #             #    #     #    #     #      #    #   #
#      #          #        #             #    #     #    #     #      #    #   #
#      #                                 #    #     #    #     #      #    #   #
#      #########################    #### #    #     #          #      #    #   #
#      #          #      #     #    #    #    ##    #########    #### #    #   #
#      #          #      #     #    #    #    #     #                 #    #   #
#      #          #                 #    #    #     #                 #    #   #
###    #    #     #                      #    #     #                 #    #   #
#      #    #     #                      #          #                 #    #   #
#      #    #     #                      #          #    ##########   #    #   #
#      #    #     #            #         #          #    #            #    #   #
#      #    #     ##########   #    #    #          #    #            #    #   #
#      #    #     #            #    #### #          #    #            #    #   #
#      #    #     #            #         #                            #    #   #
#      #    #     #            #         ####################    #### #    #   #
#      #    #     #      #     #         #     #         #            #    #   #
#      #    #     #      #     #         #     #                      #    #   #
#      #          #                      #     #                      #    #   #
#      ######     ##    ################ #     #                      #    #   #
#      #          #    #                 #     #                      #    #   #
#      #          #    #                 #     #                      #    #   #
#      #          #    #                 ##    ############    ###### #    #   #
#      #          #    #                 #          #                 #    #   #
#      #    ###   #    #####    ######## #          #                 #    #   #
#      #    #                            #          #                 #    #   #
#      #    #                            #                            #    #   #
#      #    #                            #                            #    #   #
#      #                                                              #    #   #
#      #########################    ################################# #    #   #
#      #                                                 #            #    #   #
#      #                                                 #            #    #   #
#      #                                                 #            #    #   #
#      #          #                                      #            #    #   #
#      #          #                                      #            #*   #   #
#      #                                                 #                 #   #
#      ####################    ######################### ########          #   #
#      #           #                                     #      #          #   #
#      #           #                                     #      #          #   #
#      #                                                 #      #     #    #   #
#      #                                                              #    #   #
#      #                                                              #    #   #
#      #                                                              #    #   #
################################################################################
