80 80
################################################################################
#         #                   #    #                          #                #
#         #                   #    #                          #                #
#         #       #           #    #                          #       #        #
#    #    #       #           #    #                          #       #        #
#    #    #       #                ###    ################### ####    #######  #
#    #    #                        #    #      #     #        #       #        #
#    #    ####    ############     #    #      #     #        #       #        #
#    #    #      #                 #    #      #     #        #       #        #
#    #    #      #            #    #    #      #     #        #                #
#    #    #      #            #    #    #      #     #        #############    #
#    #    #      #     #      #    #    #      #     #        #        #       #
#    #    #      #     ##     #    #    #      #     #        #        #       #
##    ####       #     #      #    #    #      #     #        #        #       #
#                #     #      #    #    #      #     #        #        #       #
#                #     #      #    #    #      ###   #        #        #       #
#                #            #    #           #     #        #        #       #
#         #      ##########   #    #           #     #        #        #       #
#         #      #      #     #    #           #     #        #        #       #
#   #     #      #      #     #    #           #     #        #        #       #
#   #     #      #      #     #    #    #            #        #        #       #
#   #     ##                  #    #    #            #        #        #       #
#   ##    #                   #    #    #            #        #        #       #
#   #     #                   #    #    #            #        #        #       #
#   #     #                   #    #    ########     #        #        #       #
#   #     #      #            #    #    #      #     #        #        #       #
#                #            #    #    #      #     #        #        #       #
###############    ########## #    #    #      #     #        ##    ## #       #
#                    #        #    #    #            #        #        #       #
#                    #        #    #    #            #        #        #       #
#                    #        #    #    #   ###      #        #        #       #
#                    #        #    #    #            #        #        #       #
#                             #    #    #      ###   #        #        #       #
#                             #    #    #      #     #        #        #       #
#                             #    #    #      #     #        #        #       #
#                                  #    #      #     #        #        #       #
################    ############## #           #     #                 #       #
#    #    #         #       #      ############      #                 #       #
#                   #       #      #     #           #                 #       #
#                   #       #      #     #           #                 #       #
#                   #       #      #     #           #        #        #       #
#             ##### #       #      #     #           ###      #        #       #
#         #         #       #      #     #    #      #        #        #       #
#         #         #       #      #     #    #   ## #        #        #       #
#  ###### #         #       #      #     #    #      #        #        #       #
#         #                 #      #     #    #      #        #        #    ####
#         #    #            #      #     #    #      #        #        #       #
#         #    #            #      #     #    #      #        #        #       #
#                           #      #     #    #      #        #        #       #
#    ############## #       #      #     #    #      #        #        #       #
#              #    #              #     #    #      #        #        #       #
#                   #              #     #    #      #        #        #       #
#                   #              #     #    #      #        #        #       #
#                   #              #     #    #      #        #        #       #
#######    ####     ####    #      #     ###    #### #        #        #       #
#              #    #       #      #     #           #        #                #
#              #    #       #      #     #           #        #                #
#              #    #       #      #     #           #        #                #
#                           #      #     #      #    #        #                #
########################    #      #     #      #    #        #        #       #
#       #     #       #     #      #            #             #        #       #
#             #             #      #            #             #        #       #
#             #             #      #                          #                #
#             #             #      #########################    ################
##    ##      #             #      #         #      #                     #    #
#       #     ###    ##    *#      #         #      #                     #    #
#       #     #       #     #      #                #                     #    #
#       #     #       #     #      #                                      #    #
#       #     #       #     #      #                                           #
######    ### #       #     #      #                                           #
#    #        ######    ### #      ###    ##########                           #
#    #        #     #       #      #        #       #                          #
#    #        #     #       #      #        #       ###################    #####
#             #     #       #      #                #     #                    #
#                           #      #                #     #                    #
#     ####                  #                       #     #                    #
#                           #                       #     #                    #
#    #                      #               #       #                          #
#    #        #     #       #               #       #                          #
################################################################################
