80 80
################################################################################
#       #      #                       #        #              #           #   #
#       #      #                       #        #              #           #   #
#              #                       #        #              #           #   #
#              #                       #        ####    ###### #           #   #
#####    ###       ################### #        #        #     ####    ### #   #
#                         #    #       #    ### #        #     #      #    #   #
#       #                 #    #       #        #        #     #      #    #   #
#       #                 #    #       #        #        #     #      #    #   #
#       #      #          #            #        #                     #    #   #
#              #          #            #        #                     #    #   #
##    ######## #####      #            #        #                     #    #   #
#              #    #     #            #        #                     #    #   #
#              #    #     #######      #        #        #     #      #    #   #
#              #               #       #        #        #     #      #        #
#              #               #       #        #        #     #      #        #
#      #       #                       #        #        #     #      #        #
#      #       #                       #            #### #     #      #        #
#                                      #                 #     #      #    #   #
####################################   #                 #     #      #    #   #
#    #            #         #    #     #                 #     #      #    #   #
#                 #         #    #     #        #        #     #      #    #   #
#                 #         #    #     #        #        #     #      #    #   #
#                 #         #    #     #        #        #     #      #    #   #
#                 #    #    #    #     #        #        #     ###         #   #
##########    ### #    #    #          #        #        #     #           #   #
#    #       #    #    #    #          #        #        #     #           #   #
#    #       #    #    #    #          #        #        #     #           #   #
#    #       #    #    #    ########   #        #        #     #      #    #   #
#    #       #         #    #    #     #        #        #     #      #    #   #
#   ##   ### #              #          #        #        #     #  *   #    #   #
#            #     ######   #          #        #        #     #      #    #   #
#            #         #    #          #        #        #     #      #    #   #
#            #    #    #    #          #        #        #     #      #    #   #
#            #    #    #    #    #     #        #              #      #    #   #
##########   #    #    #    #    #     ######    ############# #      #    #   #
#   #        #    #         #    #     #     #    #            #      #    #   #
#   #             #         #    #     #     #    #            #      #    #   #
#   #             #         #    #     #     #    #            #      #    #   #
#   #             #         #    #     #     #    #            #      #    #   #
#                 #    #    #    #     #     #    ##########   #      #    #   #
#            #    #    #    #    #     #     #    #            #      #    #   #
#            #    #    #    #    #     #     #                 #      #        #
#                      #    #    #     #     #                 #######    ######
#######################     #    #     #                #      #    #     #    #
#             #    #        #    #     #                ####   #    #     #    #
#             #    #        #    #     #          #     #      #    #     #    #
#             #    #        #    #     #          #     #      #    #     #    #
#             #    #        #    #     #     #    #     #      #    #     #    #
#     #       #    #        #    #     #     #    #     #      #          #    #
##    #   ### #    #        #    #     #     #    #     #      #          #    #
#     #       #    #        #    #     #     #    #     #      #         ##    #
#     #       #    #        #    #     #          #     #      #               #
#     #       #    #        #    #         ###### #     #      #    #          #
#     #       #    #        #    #                #     #      #    #          #
#     #       #    #        #    #                #     #      #               #
###    ###### #    #        #    #                ##    #      ######    ##    #
#        #         #        #    #     #    #     #     #      #          #    #
#        #                  #    ##    #    #     #     #      #          #    #
#                           #    #     #    #     #     #      #          #    #
#                           #    #     #    #     #     #      #          #    #
#             #             #    #     #                                       #
#             #    #        #    #     #######    ##############################
#        #    #    #        #    #     #                               #       #
#        #         ##    ## #    #     #                               #       #
#######    ####### #        #    #     #                               #       #
#                  #        #    #     #                               #       #
#                  #        #    #     #                               #       #
#                  #        #    #     #                               #    ####
#           #      #        #    #     ###############    ############ #       #
#           ####   #        #    #     #              #     #          #       #
#      #    #      #        #    #     #              #                        #
####   #    #      #        #    #     #                                       #
#      #    #      #        #    #     #                                       #
#      #           #             #     #                                       #
#      #######     #             #     ###    ######## ######    ##### #       #
#      #           #             #     #              #                #       #
#      #           #             #     #              #                #       #
#      #           #        #    #     #              #                #       #
################################################################################
