80 80
################################################################################
#                                                                     #        #
#                                                                     #        #
#                                                                     #    #   #
####    ############################################################# #    #   #
#                 #             #              #    #       #    #    #    #   #
#                 #                            #    #       #    #    #    #   #
#                                              #    #       #    #    #    #   #
#                                              #    #       #    #    #    #   #
##    ############                             #    #       #    #    #    #   #
#         #        ####################    ### #    #       #    #    #    #   #
#         #       #      #                     #    #       #    #    #    #   #
#                 #      #                     #    #       #    #    #    #   #
#                 #      #                     #            #         #    #   #
#                 #                            #            #         #    #   #
#                 #                            #     ####   #         #    #   #
#                 #                            #            #         #    #   #
#                                              #    #       #    #    #    #   #
########################################    ## #    #       #    #    #    #   #
#          #            #      #    #    #     #    #       #    #    #    #   #
#          #            #      #    #    #     #    #       #    #    #    #   #
#          #            #           #    #     #    #       #    #    #    #   #
#          #            #           #    #     #    #       #    #    #    #   #
#          #######      #           #          #    #       #    #    #    #   #
######     #    #       #           #          #    #       #    #    #    #   #
#   #      #    #       ##    ##### #          #    #       #####     #    #   #
#   #      #    #       #           #          #    #       #         #    #   #
#   #      #    #       #           #    #     #    #       #         #    #   #
#   #      #    #       #           #    #     #    #       #         #    #   #
#   #      #    #       #           ##    #### #    #       #         #    #   #
#   #      #    #       #           #    #     #            #         #    #   #
#   #      #    #       #    #      #    #     #######      #    #    #    #   #
#   #      #    #       #    #           #     #    #       #    #    #    #   #
#   #      #    #       #    #           #     #    #            #    #    #   #
#   #      #    #       #    ##                #    #            #    #        #
#   #      #    #       #    #                 #                 #    #    #####
#   #   ## #    #       #    #      #          #                 #    #    #   #
#   #      #    #       #    #      #     ##   #                      #    #   #
#   #      #    #       #    #      #    #     #############    ##### #    #   #
#   #      #    #       #    #      #    #     #        #        #    #    #   #
#   #      #    #       #    #      #    #     #        #        #    #    #   #
#   #      #    #       #    #                 #        #        #    #    #   #
#   #      #    #       #####    ##############         #        #    #    #   #
#   #      #    #       #         #                     #        #    #    #   #
#   #      #            #         #                     #        #    #    #   #
#   #      #            #         #                #### #        #    #    #   #
#   #      #            #                      #        #        #    #    #   #
#   #      #            #                #     #        #   #### #    #    #   #
#   #      #    #       #                #     #        #        #    #    #   #
#   #      #    ####    #                #     #        #        #    #    #   #
#   #      #    #       #         #      #     #        #             #    #   #
#   #      #    #        ##########      ##    #        #             #    #   #
#   #      #    #               #        #     #                      #    #   #
#          #    #               #        #     #                      #    #   #
#          #    #               #        #     #                 #         #   #
#          #    #       #                #     #                 #         #   #
#          #    #       #                #     #        #        #         #   #
#   #      #                             #     #        #        #         #   #
#   #      #############################    ## #        #        #    #    #   #
#   #      #          #         #              #        #        #    #    #   #
#   #      #          #                        #        #        #    #    #   #
#   #      #          #                        #        #             #    #   #
#   #      #    #     #    #                   #        ###    ###### #    #   #
#   #      #    #     #    #     ##    ####### #        #      #      #        #
#   #           #     #    #    #              #        #      #      #        #
#   #           #     #    #    #              #        #      #      #        #
#   #           #     #    #    #              #        #      #      #        #
#   #           #     ###    ## #              #        #             #    #   #
#   #      #    #     #         ###    ## #    #        #*            #    #   #
#   #      #    #     #         #         #    #        #             #    #   #
#   #      #    #               #         #    #        #             #    #   #
#   #      #    #               #         #    #        #      #      #    #   #
#   #      #               #                   #        #      #      #    #   #
#   #      #######     #####    ############## #        ###    #      #    #   #
#   #      #    #     #              #         #        #      #      #    #   #
#   #      #          #              #         #        #      #      #    #   #
#   #      #          #                        #        #      #      #    #   #
#   #      #          #                        #        #      #      #    #   #
#   #      #          #                        #        #      #      #    #   #
################################################################################
