80 80
################################################################################
#    #            #       #      #                        #                    #
#    #            #       #      #                        #                    #
#    #            #       #      #     #                  #                    #
#    #    ####### #       #      #     #####    ######### ###########    #######
#                 #       #            #                  #                    #
#                 #       #            #                                       #
#                 #       #            #                                       #
#          #      #       ###    ##### #                                       #
#    #     #      #       #     #      #####    ################################
#    #     #      #       #     #      #                    #       #          #
#    #     #      #       #            #                            #          #
#    #     #              #            #                            #          #
#    #     #              ##           #                            #          #
#    ###   #              #            #                            #    #     #
#    #     ##             #     ####   #                            #    #######
#    #     #      #       #     #      #                            #      #   #
#    #     #      #       #     #      ###    ##################### #      #   #
#    #     #      #       #     #      #                            #          #
#    #     #      #       #     #      #                                       #
#                 #       #     #      #                                       #
#############     #       #                                                    #
#          #      #       ######################    ############################
#          #      #       #           #       #                                #
#          #      #####   #           #       #                                #
#          #      #       #           #       #                                #
#                 #       #    #      #       #                                #
#                 #       #    #      #       #                                #
#                 #       #           #       #########    #####################
#                         ######      #    ## #    #    #     #           #    #
############    ######### #                   #    #    #     #                #
#     #     #     #       #                   #    #    #     #                #
#     #     #     #       #                   #    #    #     #                #
#     #     #     #       #                   #               #                #
#           #             ##    ############# #               #                #
#           #             #    #     #                        #                #
##          #             #    #                              #   ##############
#           #             #    #                   #    #     #     #          #
#     #     #     #       #    #                   #    #     #     #          #
#     #     #     ####    *    #              #    #    #     #     #          #
#     #     #     #            #    ##        #    #####      #     #          #
#           #     #            #     #        #    #    #           #######    #
#########   #     #                  ###      #    #    #           #    #     #
#           #     #       #          #        #    #    #                #     #
#           #     #       #          #        #    #    #                #     #
#           #     #       #          #        #    #    #     #          #     #
#           #     #       #######    #        #    #    #     #          #     #
#     #           #       #     #    #        #    #    #     #     #    #     #
###   #           #       #     #    #        #    #    #     #     #          #
#     #           #       #     #    #        #    #          #     #          #
#     #           #       #     #    #        #    #          #     #          #
#     #     #     #       #          #        #    #          #     #          #
#     #     #     #       #          #        #    #                #          #
#     #     #     #       #          #        #    ##############    ###########
#     #     #     #       #          #        #    #     #       #             #
#     #     #     #       #     #    #        #    #     #       #             #
#     ###   #     #       #     #    #        #    #     #       #             #
#     #     #     #       #     #    #        #    #     #       #             #
#     #     #     #       #     #    #        #    #     #       ##    #########
#     #     #     #       #     #    #        #    #     #       #       #     #
#     #     #     #       #     #    #        #    #     ##      #       #     #
#     #     #     #       #     #    #        #    #     #       #       #     #
#     #     #     #       ###   #    #        #    #     #       #       #     #
#                 #       #     #    #        #    ###           #       #     #
#############     #       #     #    #        #    #             #       #     #
#   #       #     #       #     #    #        #    #             #       #     #
#   #       #     #       #     #    #        #    #             #    ## #     #
#   #             #       #     #    #        #    #             #       #     #
#   #             #       #     #    #        #    ####    ##### #       ###   #
#   #             #       #     #    #        #    #     #                     #
#   ###########   #       #     #    #        #    #     #                     #
#   #     #       #       #     #    #        #    #     #                     #
#         #       #       #     #    #        #    #                           #
#         #       #       #     #    #        #    #             #       #     #
#         #       #       #     #    #        #    #             #       #     #
#         #       #       #     #    #        #    #   ## ##     #       #     #
#   #             #       #     #    #        #    #     #       #       #     #
#   #             #       #     #    #        #    #     #       #       #     #
#   #             #       #     #    #        #    #     #       #       #     #
################################################################################
