80 80
################################################################################
#          #                  #                                   #            #
#          #                                                      #            #
#          #                                                      #            #
#   #      #             #                                                     #
#   #      #             #                                                     #
#   #      #             #    #                                                #
#   #      #                  #                                                #
#   #      #######    ####### ##########################    ####################
#   #      #                  #    #     #                                     #
#   #      #                  #    #     #                                     #
#   ##     #                  #          #                                     #
#   #      #                  #          #                                     #
#   #      #        ######    #          #########    ##########################
#   #      ######   #    #    #    ######                                      #
#   #      #        #    #    #                                                #
#   #      #        #         #                                                #
#   #      #        #         #                                                #
#   #      #        #                                                          #
#   #      #######    ##########################################################
#   #      #         #      #                      #                           #
#   #      #         #      #                      #                           #
#   #      #         #      #                      #                           #
#   #      #         #      #                      #                           #
#   #      #         #      #########    ######### #####    ####################
#   #      #             ## #     #        #       #               #       #   #
#   #      #                #     #        #       #               #       #   #
#   #      ####    ##       #     #        #       #                       #   #
#   #      #                #     #        #       #                       #   #
#   #      #         #      #     ##    ## #       #    #                  #   #
#   #      #         #      #     #        #       #    #######    ####### #   #
#   #      #                #              #       #    #                  #   #
#   #      #####    ####### #              #       #    #                  #   #
#   #      #                #              ####    #    #                  #   #
#   #      #                #    *         #       #                       #   #
#   #      #                #     #                #########    ########## #   #
#          #                #     #                #             #    #    #   #
#######    #                ######    #####        #             #    #    #   #
#   #      #    ###    #####                       #             #    #    #   #
#   #      #    #                          #       #    #        #    #    #   #
#   #      #    #                          #       #    #        #    #    #   #
#   #      #    #                #         #       #    #        #    #    #   #
#   #      #    #    #      #    #    #### #       #    #        #    #    #   #
#   #      #    #    #      #    #         #       #    #        #    #    #   #
#   #      #    #    #      #    #         #       #    #        #    #    #   #
#   #      #    #    #      #    #         #       #    #        #    #    #   #
#   #      #                     #                 #    #        #    #    #   #
#   #      ###################    ################ #    #        #    #    #   #
#   #      #      #                #               #    #        #         #   #
#   #      #      #                                #    #        #         #   #
#   #      #      #                                #    #        #         #   #
#   #      #      #                                #    ###      #         #   #
#   #      #      #                                #    #        #    #    #   #
#   #      #      #                                #    #        #    #    #   #
#   #             #                                #    #        #    #    #   #
#   #             ##########################    ## #             #    #    #   #
#   #             #        #      #                #   ######### #    #    #   #
#   #             #        #      #                #        #    #         #   #
#   #      #      #        #      #                #        #    #   ######    #
#   #      #      #        #      #        #       #        #    #    #        #
#   #      #      ######   #      #        #       #        #    #             #
#   #      #      #        ##     #        #       #        #    #             #
#          #      #        #      #        #       #        #    #         #   #
#          #      #        #      #        #       #        #    #         #   #
#          #      #        #      #        #             ## #    #    #    #   #
#          #                      ####     #                #    #    #    #   #
#   #      #                      #        ####             #    #    #    #   #
#   #      #                               #                #    #    #    #   #
#   #      #                               #       #        #    #    #    #   #
#   #      ###    ##########    ##         #       #        #    #    #    #   #
#   #      #      #                        #       #        #    #    #    #   #
#   ####   #      #               #        #       #        #         #    #   #
#   #      #      #               #                #        #         #    #   #
#   #      #      #               #############    #        #         #    #   #
#   #      #      #      ######   #        #       #        #         #    #   #
#   #      #      #      #        #                #        #    #    #    #   #
#   #      #      #      #        #                #        #    #    #    #   #
#   #      #      #      #        #                #             #    #    #   #
#   #      #      #      #        #                #             #    #    #   #
################################################################################
