80 80
################################################################################
#                      #           #           #    #        #     #       #   #
#                      #                       #    #        #     #       #   #
#                      #                       #    #        #     #       #   #
##############    #### #                       #    #        #     #       #   #
#      #     #         ####    ################     #        #     #       #   #
#      #     #         #                            #        #     #       #   #
#      #     #         #                            #        #     #       #   #
#      #               #                            #        #     #   ### #   #
#      #               #                            #        #             #   #
#                      #####    ################### #        #             #   #
#                      #             #              #        #             #   #
#                      #             #              #        #             #   #
#                      #             #              #        #     #           #
##    ###    ##########                             #        #     #           #
#      #                                            #        #     #           #
#      #                                            #        #     #           #
#      #                                            #        #     #       #   #
#                                                   #        #     #       #   #
#########################    ###################### #        #     #       #   #
#                #                     #    #       #        #     #       #   #
#                #                     #    #       #        #     #       #   #
#                #                     #    #       #        #     #       #   #
#                #                     #    #       #        #     #       #   #
#########    ### ##################    #            #        #     #       #   #
#                                      #            #        #     #       #   #
#                                      #            #        #     #       #   #
#                                      #            #        #     #       #   #
#                                      #    #    ## #        #     #       #   #
#########################    ######### #    #       #              #       #   #
#    #    #    #    #        #         #    #       #              #       #   #
#    #    #    #             #              #       #              #       #   #
#    #    #    #             #              #       #              ########    #
#    #    #    #             #                      #        #     #           #
#         #    #             #          ######      #        #     #           #
#              ########      #         #      #     #        #     #           #
#              #             #         #      #     #        #     #           #
#              #             ####      #      #     #        #     #      #    #
#    #         #             #         #      #     #        #     #      #    #
#    #    #    #             #         #      #     #        #     #      #    #
#    #    #    #     #       #         ####   #     #        #     #      #    #
#    #    #    ###   ##    ##          #      #     #        #     ###    #    #
#    #    #    #     #                 #      #     #        #     #      #    #
#    #    #    #     #                 #      #     #        #     #      #    #
#    #    #    #     #                 #      #              ##    #      #    #
#    #####     #     #                 #      #              #     #      #    #
#    #    #    ######    ############# #      #              #     #      #    #
#    #    #    #         #       #     #      #              #     #      #    #
#    #    #    #         #       #     #      #     #        #     #      #    #
#    #    #    #         #       #     #      #     #  *     #     #      #    #
#    #    #    #         #       #     #      #     #        #     #      #    #
#    #         #         #       #     #      #     #        #     #      #    #
#    #         #         #       #     #      #     #        #     #      #    #
#    #         #         #       #     #      #     #        #     #      #    #
#    #         #         #       #     #      #     #        #     #      #    #
#              ####      #       #     #      #     #        #     #      #    #
#########      #         #       #     #      #     #        #     #      #    #
#       #      #         #       #     #      #     #####    #     #      #    #
#       #      #         #       #     #      #     #        #     #      #    #
#       #      #         #             #      #     #        #                 #
#       #      #         #             #      #     #        ################  #
####    ##     #         #             #      #     #        #         #       #
#       #      #             ####      #      #     #        #                 #
#       #      #                 #     #      #     #        #                 #
#       #      #                 #     #      #     #        #                 #
#       #      #                 #     #      #     #        #                 #
#       #                #             #      #     #        #         #       #
#       #                ##########    #      #     #        #         #       #
#       #                #        #    #      #     #                          #
#                        #        #    #      ##    ###    #####################
#              #         #        #    #      #     #           #      #       #
#              #         #        #    #      #     #                  #       #
#              #         ######   #    #      #     #                  #       #
#       #      #         #        #    #      #     #                  #       #
#       #      #         #        #    #      #     #                  #   #####
#       #      #         #             #      #     #######    ####### #       #
#       #      #         #             #            #                          #
#       #      #         #             #            #                          #
#       #      #         #             #            #                          #
################################################################################
