80 80
################################################################################
#   #    #                         #         #                            #    #
#   #    #                         #         #                                 #
#   #    #                         #         #                                 #
#   #    #    #################### ####      #                                 #
#   #    #                                   #                                 #
#   #    #                                    #########    #####################
#   #    #                                        #                    #       #
#   #    #                                                             #       #
#   #    ################################                              #       #
#   #    #     #                #     #      #                         #       #
#   #    #     #                #     #      #     #############    ## #       #
#   #    #                      #     #      #    #    #               #       #
#   #    #                      #     #      #    #    #               #       #
#   #    #                      #     #      #    #    #               #       #
#   #    #                      #     #   ## #    #                        #####
#   #    ##    #################      #      #    #                            #
#   #    #             #                     #    #                            #
#   #    #             #                     #                                 #
#   #    #                                   ######    ############### #       #
#   #    #                      #   ######## #           #             #       #
#   #    #                      #            #                         #       #
#   #    #                      #            #                         #       #
#   #    #                      #            #                         #       #
#   #    #                                                                     #
#   #    #####################################################    ##############
#   #    #        #             #                                         #    #
#   #    #        #                                                       #    #
#   #    #        #                                                       #    #
#        #        #                                                       #    #
#        #        #                                                            #
#        #        #                                                            #
#        #        #####################    ###############################     #
#   #    #        #      #         #                                           #
#   #    #        #                #                                      #    #
#   #    #        #                #                                      #    #
#   #    #        #                #                                      #    #
#   #    #        #                #                           #          #    #
#   #    #        #                #                           #          #    #
#   #    #        #                #                                      #    #
#   #    #        ##    ########### #################################     #    #
#   #    #        #                            #                          #    #
#   #    #   #### #                                                       #    #
#   #    #                                                                #    #
#   #    #              #          #                                      #    #
#   #    #         ##   #   ###### #########    #######    ############## #    #
#   #    #              #          #           #                          #    #
#   #    #        #     #          #           #                          #    #
#   #    #        #     #          #           #                          #    #
#   #    #                                                                #    #
#    ### ###############################################    ############# #    #
#   #    #                           #       #    #              #        #    #
#   #    #                           #       #                   #        #    #
#   #    #                           #       #                   #        #    #
#   #    #                                   #                   #        #    #
#   #    #                                   #                   #        #    #
#   #    #                                   #    #              #        #    #
#   #    ##############################      #    #              #        #    #
#   #    #            #                      #    #              ####     #    #
#   #    #            #                      ###    ############ #        #    #
#   #                 #                                          #        #    #
#   #            #    #                                          #        #    #
#   #            #    ############    #######                    #        #    #
#   #                 #    #           #                                  ##   #
#   #    #   ######## #                #     #                            #    #
#   #    #     #      #                #     #                            #    #
#   #    #     #      #          #           ##############    ########## #    #
#   #    #     #      #          #           #      #                     #    #
#        #     #      #    #                 #      #                     #    #
#        #     #      #    ##    ######      #      #                     #    #
#        #     #      #    #           #     #                    #       #    #
#        #     ###    #    #           #     # *                  #       #    #
#   #    #     #      #    #           #     #                    #       #    #
#   #    #     #                       #     #                    #       #    #
#   #    #     #       ########    ### ###   ##############    ## #####   #    #
#   #    #     #                 #     #     #                    #       #    #
#   #    #                       #     #     #                    #       #    #
#   #    #            #                #     #                    #       #    #
#   #    #            #                #     #                    #       #    #
################################################################################
