80 80
################################################################################
#   #    #                                                     #    #     #    #
#   #    #                                                     #          #    #
#   #    #                                            #        #          #    #
#        ###############################    ######### #        #          #    #
#        #    #                             #         #        #   #######     #
#        #    #                                       #####    #               #
#        #    #                                       #        #               #
#   #    #    #                                       #        #               #
#   #    #    #    #########################     #    #        #               #
#   #    #    #                             #    #    #        #               #
#   #    #    #                             #    #    #        #############   #
#   #    #    #                             #    #    #        #    #      #   #
#   #    #    #                             #    #    #        #    #      #   #
#   #    #    ###########    ######## ##    #    #    #        #    #          #
#   #    #    #                       #     #    #    #        #    #          #
#   #    #                            #     #    #    #        #    #          #
#   #    #                            #     #    #    #        #    #          #
#   #    #                                  #         #        #    #    #######
#   #    #########    ##################### ######    #        #    #          #
#   #    #       #          #      #        #    #    #                        #
#   #    #       #          #      #        #    #    #                        #
#   #    #       #          #      #        #    #    #                        #
#   #    #       #          #               #         ###################    ###
#        #                  #               #         #          #             #
#   #### #                  #               #         #          #             #
#   #    #                                  #         #          #             #
#   #    #                                  #    #    #          #             #
#   #    ######    #########                #    #    #    ###### #####    #####
#   #    #                   ############   #    #    #    #          #        #
#   #    #                  #               #    #    #                        #
#   #    #                  #               #    #    #                        #
#   #    #                  #               #    #    #                        #
#   #    #                                       #                             #
#   #    #####################################    ##############################
#   #    #                #                       #      #                     #
#   #    #                #                       #                   *        #
#   #    #                                        #                            #
#   #    #                                        #                            #
#   #    ##############    ###########    ####### #                            #
#   #    #       #                                #   ##########################
#   #    #       #        #                       #          #                 #
#   #    #                #                       #          #                 #
#   #    #                #                       #          #                 #
#   #    #                                        #          #                 #
#   #    ##########    ########################## ######     #       #     #   #
#   #    #                 #            #         #          #       #######   #
#   #    #                              #         #          #       #    #    #
#   #    #                              #         #          #       #    #    #
#   #    #                       #      #         #          #       #    #    #
#   #     ##############         #                #    #     #####   #    #    #
#   #            #    #    #     #                #    #     #       #    #    #
#   #            #    #    #     #                #    #     #       #    #    #
#   #            #    #    #     ##    ########## #    #     #       #    #    #
#   #    #       #    #    #     #                #    #     #       #    ###  #
#   #    #       #    #    #     #                     #     #       #         #
#   #    #       #    #    #     #                     #     #       #         #
#   #    #       #    #    #     #      #              #     #       #         #
#   #    #       #    #    #            #              #     #       #         #
#   #    #       #    #    #############    ##### #    #     #       #    #    #
#   #    #   ### #    #    #        #             #    #     #       #    #    #
#   #    #       #    #    #        #             #    #     #       #    #    #
#   #    #       #    #    #        #             #    #     #       #    #    #
#   #    #       #         #                      #    #     #       #    #    #
#   #    #                 #                      #    #     #       #    #    #
#   #    #                 #                      #    #     #       #    #    #
#   #    #                 #             ######## #    ##    #       #    #    #
#   #    #        ######   #        #    #        #    #     #                 #
#   #    #       #    #    #        #    #        #    #     ###    ############
#   #    #       #    #    #        #    #        #    #     #          #      #
#   #    #       #         ##    ## #    #        #    #     #          #      #
#   #    #       #         #        #    #        #    #     #          #      #
#   #    #       #         #        #    #        #    #          #            #
#   #    #       #         #        #    #        #    #          #            #
#   #    #       #    #    #        #          ## #    #          #            #
#        #       #    #    #        #             #    #          ##########   #
#        #       #    #    #        #             #    #     #    #            #
#        #       #    #    #        #             #    #     #    #            #
#        #       #    #    #        #    #        #    #     #    #            #
################################################################################
