80 80
################################################################################
#   #    #      #    #    #          #                            #            #
#   #    #      #         #          #                            #            #
#   #    #      #         #          #                            #            #
#   #           #          ######    #   ######################## #            #
#   #           #              #     #                                   #     #
#   #           #    #         #     #                                   #     #
#   #           #    #         #     #                                         #
#   #    #      #    #    #    #     #                 #           #######    ##
#   #    #      #    #    #    #     #                 #          #            #
#   #    #      #    #    #    #     #                 #          #            #
#   #    #           #    #    #     #                 #          #            #
#   #    #           #    #    #     #                                         #
#   #    #           #    #    #     ######################################    #
#   #    #                #    #     #     #     #       #     #    #    #     #
#   #    #      #######   #    #     #     #             #          #          #
#   #    ###    #         #    #     #                   #          #          #
#   #    #      #         #    #     #                   #          #          #
#   #    #      #         #    #                         #          #          #
#   #    #      #         #    #                 #       #     #    #    #     #
#   #    #                #    #           #     #       #     #    #    #######
#   #    #    ########### #    #           #             #          #    #     #
#   #    #       #        #    #     #     ########      #    ##### #    #     #
#   #    #       #        #    #     ###   #             #    #     #    #     #
#   #    #       #        #    #     #     #             #    #     #    #     #
#   #    #                #    ##    #     #             #    #     #          #
#   #    #                #    #     #     #             #    #     #          #
#   #    #                #    #     #     #             #        ##         ###
#   #    #                #          #     #             #                     #
#   #    ###    ##    ### #          #                   #               #     #
#   #    #       #        #          ################    #               #     #
#        #       #        #          #          #        #                     #
#        #       #        #          #          #        ###################   #
#        #                           #          #             #                #
#        ##    ##################### #          #             #                #
#   #    #                     #     #   ###### ###    ##     #                #
#   #    #                     #     #                                         #
#   #    #                           #                   #                     #
#   #    #                           #                   #                     #
#   #    #                                                                     #
#   #    ##########################################################    #########
#        #     #                                    #                    #     #
#   #### #     #                                    #                    #     #
#   #    #     #                                                         #     #
#   #    #     #                                                         #     #
#   #    #     #########################    ######## ########    ####### #     #
#   #    #     #               #                                         #     #
#   #    #     #                                    #               *    #     #
#   #    #     #                                    #                    #     #
#   #    #     #                                    #                    #     #
#   #    #     #                                                         #     #
#   #    #     ######    ############################################### #     #
#   #    #                                                               #     #
#   #    #                                                               #    ##
#   #    #                                                               #     #
#   #    #                                                               #     #
#   #    ########    ################################################### #     #
#   #    #     #     #                              #     #    #         #     #
#   #    #     #     #                              #     #    #         #     #
#   #    #     #     #                                    #    #         #     #
#   #    #     #     #      #                             #              #     #
#   #    #     #     #      #                             #              #     #
#   #    #           #      #                             #              #     #
#   #    #           #      ####    ##################### #                    #
#   #    #           #      #               #             #                    #
#   #    ####    ### #      #                             #                    #
#   #    #     #            #                             ######    #####      #
#   #    #     #            #                             #              #     #
#   #    #                  #                                            #     #
#   #    #                  #                                            #     #
#   #    #           #      #                                            #     #
#   #    #           #      ########################################     #     #
#   #    #           #      #                                            #     #
#   #    #           #      #                                            #     #
#        #########    ##### #                                            #     #
#        #       #          #     #                                      #     #
#        #                  #     #                                      #     #
#        #                  #     #                                      #     #
#   #    #                  #     #                                      #     #
################################################################################
