80 80
################################################################################
#    #    #    #                                                               #
#    #    #    #                                                               #
#    #    #    #                                                               #
#    #    #    #                                                               #
#    #    #    ###################################################    ##########
#    #    #    #                                        #        #      #      #
#    #    #    #                                        #        #      #      #
#    #    #    #                                        #        #      #      #
#    #    #    #                                        #        #      #      #
#    #    #    #                            #           #        #      #      #
#    #    #    #                            #           #        #      #      #
#    #    #    #                            #           #        #      ###    #
#    #    #    #                                        #        #      #      #
#    #         ##################    ################## #        #      #      #
#    #         #       #             #    #             #        #      #      #
#    #         #       #             #    #             #        #      #      #
#    #         #       #             #    #             #        #      #      #
#    #    #    #                     #    #             #        #      #      #
#    #    #    #               #     #    #####    #### #        #      #      #
#    #    #    ####            #     #    #      #               #      #      #
#    #    #    #               #          #      #               #      #      #
#    #    #    #       #       #          #      #               #      #      #
#    #    #    #       #####    #####     #                      #      #      #
#    #    #    #       #      #                         #        #      #      #
#    #    #    #       #      #      #         ##       #        #      #      #
#    #    #    #       #      #      #                  #        #      #      #
#    #    #    #       #             #           #      #        #      #      #
#    #    #    #       #             #    #      #      #        #      #      #
#    #    #    #       #    ##       #    #      #      #        #      #      #
#    #    #    #       #             #    #      #      #        #      #      #
#    #    #    #       #      #      #    #      #      #        #      #      #
#    #    #    #       #      #      #    #      #      #        #      #      #
#    #    #    #              #      #    #      #      #        #      #      #
#    #    #    ############    ##### #    #      #      #        #      #      #
#    #    #    #          #    #     #    #      #      #        #      #      #
#    #    #    #          #    #     #    #      #      #        #      #      #
#    #    #    #          #          #    #      #      #        #      #      #
#    #    #    #          #          #    #      #      #   #### #      #      #
#    #    #    #####      #          #    #      #      #        ##     #      #
#    #    #    #    #     #######    #    #      #      #        #      #      #
#    #    #    #    #     #     #    #    #      #      #      * #      #      #
#    #    #    #    #     #     #    #    #      #      #        #      #      #
#    #    #    #    #     #     #    #    #      #      #        #             #
#         #    #    #     #     #    #                  #        #             #
#         #    #          #     #    ################   #        #             #
#         #    #          #     #    #        #         #        #             #
#         #    #           ##   #    #        #         #        #######    ####
#    #    #                          #                  #        #    #    #   #
#    #    #         #                #                  #        #    #    #   #
#    #    #         #                #                  #        #    #    #   #
#    #    #                                                      #    #    #   #
#    #    #    #######################    ###################### #    #    #   #
#    #    #    #                                         #       #    #    #   #
#    #    #    #                                         #       #    #    #   #
#    #    #    #                                         #       #    #    #   #
#    #    #    #              #                          #       #    #    #   #
#    #    #    #              #                          #       #    #        #
#    #    #    #              #                          #       #    #        #
#    #    #    #                                         #       #    #        #
#    #    #    ##################    ################### ###     #    #        #
#    #    #    #       #                #       #        #       #    #    #   #
#    #    #    #       #                #       #        #       #    #    #   #
#    ##    ### #       #                        #        #       #    #    #   #
#    #    #    #       #                        #        #       #    #    #   #
#    #    #    #    ## #                        #        #       #         #   #
#    #    #    #       #                        #        #       #         #   #
#    #         #       ##########    ########## #    ####        #         #   #
#    #         #                                #                #         #   #
#    #         #                                                           #   #
#    #         #                                                           #   #
#    #    #    #                                         #           ##### #   #
#    #    #    #                                         #                 #   #
#    #         ###########    ################# #        #       #         #   #
#####    ##### #                                #        #       #         #   #
#              #                                #        #       #         #   #
#              #                                #        #       #    #    #   #
#              #            #                   #        #       #    #    #   #
#              #            #                   #        #       #    #    #   #
################################################################################
