80 80
################################################################################
#       #    #      #                             #                            #
#       #    #      #                             #                            #
#       #    #      #         #                   #                            #
#       #    #      #    #    #   ####            #                            #
#       #    #      #    #    #       #                                        #
#       #    #      #    #    #       #                                        #
#       #    #      #    #    #       #                                        #
#       #    #      #    #            #################################    #####
#       #    #      #    #########    #              #        #       #        #
#       #    #      #    #       #    #              #        #       #        #
#       #    #      #    #            #              #        #       #        #
#            #      #    #            #              #                #        #
#            #      #    #            #    ##        #                #        #
#            #      #    #   ####     #     #        #                         #
#            ##     #    #       #    #     #        #                         #
#       #    #      #    #       #    #     #        #                         #
#       #    #      #    #       #    #     #        ######    #######         #
#       #    #      #    #       #    #     #        #    #     #     #        #
#       #    #      #    #       #    #     ##    ## #    #     #     #        #
#       #    #      #    #       #    #     #        #    #     #     #        #
#       #    #      #    #       #    #     #        #    #     #     #        #
#       #    #      #    #       #    #     #        #    #     #     ####    ##
#       #    #      #            #    #     #        #    ###   #     #        #
#       #    #      ##########    ### #     #        #    #     #     #        #
#       #    #      #       #    #    #     #        #    #     #     #        #
#       #    #      #       #    #    #     #        #    #     ###   #        #
#       #    #      #       #    #    #     #        #    #     #     #        #
#       #    #      #       #    #    #     #        #    #           #        #
#       #    #      #       #    #    #     #        #    #           #        #
#####   #    #      #       #    #    #     #        #    #           #        #
#       #    #      #       #    #    #     #        #    #   ####### #        #
#       #    #      #    ## #    #    #     #        #                #        #
#       #    #      #       #    #    #     #        #                #        #
#       #    #      #       #    #    #     #        #                #        #
#       #    #      #       #    #    ######    #### #         #      #        #
#       #    #      #       #    #    #       #      #    #    #   ## #        #
#       #    #      #       #    #    #       #      #    #    #      #        #
#       #           #       #    #    #       #      #    #    #      #        #
#       #           #            #    #       #      #    #    #      #        #
#       #           #            #    #       #      #                         #
#       #           #            #    #       #      ############    ###########
#       #           #            #    #       #      #     #           #       #
#       #           #       #    #    #              #     #           #       #
#       #########   #       #    #    #              #     #           #       #
#       #           #       #         #              #     #           #       #
#       #           #       #         #              #     #     #     #       #
#       #           #       #         #       #      #     #     #     #       #
#       #           #       #         #       #      #     ##    #     #       #
#       #     ###   #       #    #    #       #      #     #     #     #       #
#       #     #     #       #    #    #       #      #     #     #     #       #
#       ###   #     #       #    #    #       #      #     #     #     #       #
#       #     #     #       #    #    #       #      #     #           #       #
#       #     #     #       #    #    #       #      #     #    ###### #       #
#       #     #     #       ##    ### #       #      #     #    #      #       #
#       #           #       #         #       #            #    #      #       #
#####    ########## #       #         #       #            #           #       #
#          #        #       #        *#####   #            #           #       #
#          #        #       #         #       #                        #       #
#          #                #    #    #       #      #                 #       #
#          #                #    #    #       #      ##         #      #       #
#                           #    #    #       #      #          #              #
#                           #    #    #       #      #     #    #              #
#                           #    #    #       #      #     #    #              #
#                                     #       #      #     #    #              #
################    ################# #       #      #     #    #      #   #####
#              #                      #       #      #     #    #      #       #
#              #                      #       #      #                 #       #
#              #                      #       #      ###############   #       #
#              #                      #       #      #          #      #       #
########    ## ########    #### #     #       #      #          #      #       #
#              #                #     #       #      #                 #       #
#                               #     #       #      #                 #       #
#                               #     #       #      #######        ## #       #
#                               #     #       #      #    #            #       #
#######################    #### #     #       #      #    #     #      #       #
#                               #     #       #      #          #      #       #
#                               #     #       #      #          #      #       #
#                               #     #       #      #          #      #       #
################################################################################
