80 80
################################################################################
#    #       #      #                       #           #            #     #   #
#    #       #      #                       #           #            #         #
#    #       #      #                       #     #     #            #         #
#    #       #      #                       #     #     #            #         #
#    #       #      ##############    ##### #     #     #######      ######    #
#    #       #      #                       ####    ### #                  #   #
#    ####    #      #                       #           #                  #   #
#    #              #                       #           #                      #
#                   #        #                          #     #                #
#                   #        #                          #     #      #         #
#                   #                                   #     #      #         #
#            ##     ###############    ################ #                      #
#   ######## #      #                                   #################    ###
#     #      #      #                                   #      #      #        #
#     #      #      #                                          #      #        #
#            #      #                              #                           #
#            #      #    ######################### #                           #
#            #      #            #      #          #                           #
#            #      #            #      #          #    #                      #
#            #      #            #      #          #    #      ########    #####
#                   #            #      #          #    #      #       #       #
##############      ###    ##    ##           #### #    #      #       #       #
#    #    #         #      #     #            #    #    #      #       #       #
#    #    #         #      #     #            #    #    #      #       #       #
#    #    #         #      #     #                 #    #      #       #       #
#    #    #         #            #                 #    #      #       ####    #
#    #    ######    ##    ###### #                 #    #      #       #       #
#    #    #    #    #             ########    #### #    #      ####    #       #
#    #    #         #                              #    #      #       #       #
#    #    #         #                              #    #      #               #
#    #    #         #                              #    #      #               #
#    #    #         #                                                          #
#    #    #    #    #########################    ###############################
#    #    #    #    #        #    #         #     #           #     #          #
#    #    #    #    #        #    #         #     #           #     #          #
#    #    #    #             #    #         #     #           #     #          #
#    #    #    #                  #         #     #           #     #    #     #
#    #    #    #                  #         #     #    ###### #     #    ###   #
#    #    #    #                  #         #     #     #     #     #    #     #
#    #    #    #    #             #         #     #     #     #     #    #     #
#    #    #    #    #        #    #         #           #           #    #     #
#    #    #    #    #        #    #         #           #           #          #
#    #    #    #    #        #    #         #           #           #    #######
#    #    #    #    #        #    #         #           #           #     #    #
#    #    #    #    #        #    #         #     #     #     #     #     #    #
#    #    #    #    #        #    #         #     #     #     #     #          #
#    #    #    #    #        #    #         #     #     #     #     #          #
#    #    #    #    #        #    #         ##    #     #     #                #
#    #    #    #    #####    #    ####      #     #     #     #                #
#    #    #    #    #        #    #         #     #     #     #           #    #
#    #    #    #    #        #    #               #           #           #    #
#    #    #    #    #        #    #               #           #                #
#    #    #    #    #             #               #           ######    ########
#    #    #    #    ####    ##### #               #           #                #
#    #    #    #    #        #    #         #     #     #     #                #
#         #    #    #        #    #         #     #     #     #                #
#         #    #    #        #    #         #     #     #     #                #
#         #    #    #        #    #         #     #     #     #                #
#         #    #    #        #    #               #                            #
#         #    #    #        #    ####    ####### ##################    ########
#   ##### #    #    #        #                    #                            #
#   #     #    #    #        #                    #                            #
#   #     #    #    #        #                    #                            #
#   #     #    #    #        #                                                 #
#   #     #    #    #        #    #######################    ###################
#   #     #    #    #        #    #                                  #         #
#   #     #    #    #        #    #                                  #         #
#         #    #    #        #    #         *                                  #
#         #    #    #        #    #                    #                       #
#         #    #    #        #    ##############    ## #                       #
#         #    #    #        #    #    #               #                       #
#   #     #    #    #        #    #                    #                       #
#   #     #    #    #        #    #                    ###########    ##########
#   ###   #    #    #        #    #                    #      #                #
#   #     #    #    #####    #    #     ######    #### #      #                #
#   #          #    #             #    #               #      #                #
#   #          #    #             #    #               #                       #
#   #          #    #             #    #               #                       #
################################################################################
