80 80
################################################################################
#                            #            #           #               #    #   #
#                            #            #           #               #    #   #
#           #                #    #                                   #    #   #
#           #######    ##### #    #                                   #    #   #
#  ######## #                #    #   #### ##   #                     #    #   #
#    #      #                #    #             ##    ############### #    #   #
#           #                #    #       #     #                     #    #   #
#           #                #    #       #     #                     #    #   #
#           #      #         #            #     #                     #    #   #
#                  #         ########     #                           #    #   #
##################    ###### #            ##################    ##### #    #   #
#   #    #    #      #       #            #         #                 #    #   #
#   #    #    #      #       #            #                           #    #   #
#   #    #    #      #       #            #                           #    #   #
#   #    #    #      #       #            #                           #    #   #
#   #    #    #      #       #                                        #    #   #
#   #         #      #       ###############################    ##### #    #   #
#   #         #      #       #    #          #     #                  #    #   #
#   #         #      #       #    #          #     #                  #    #   #
#   #         #      #       #    #          #     #                  #    #   #
#   #    #    #      #       #    #          #     #            #     #    #   #
#   #    #    #      #       #    ########   #     #            #     #    #   #
#   #    #    #      #       #    #    #     #     #            #     #    #   #
#   #    #    #      #       #    #    #     #      ############      #    #   #
#   #    #    #      #       #    #    #     #               #        #    #   #
#   #    #    #      #       #    #    #     #               #        #    #   #
#   #    #    #      #       #               #               #        #    #   #
#   ##    ### #      ###     #               #     #         #        #        #
#   #         #      #       #               #     #######            #        #
#             #      #       #               #     #                  #        #
#             #      #       #    #    #     #     #                  #        #
#             #      #       #    #    #     #     #                  #    #   #
#             #      #       #    #    #     #     #         ##    ## #    #   #
#   #    #    #      #       #    #    #     #     #    #    #        #    #   #
#   #    #    #      #       #         #     #     #    #    #        #    #   #
#   #    #    #      #       ##########      #     #    #    #        #    #   #
#   #    #    #      #       #     #         #     #    #    #        #    #   #
#        #    #      #       #     #         ##    #    #    #        #    #   #
#########     #      #       #     #         #     #    #    #        #    #   #
#        #    #      #       #     #         #     #    #    #        #    #   #
#        #    ###    #       #     #    #          #    #    #        #    #   #
#        #    #      #       #     #    #                             #    #   #
#   #    #    #      #       #     #    #     ###################     #        #
#   #    #    #      #       #     #    #          #         #        #   ######
#   #    #    #      #       #     #    #    #     #         #        #    #   #
#   #         #      #       #     ###    ## #     #         #        #    #   #
#   #         #              #     #    #    #     #         #        #    #   #
#   #         #              #     #    #    #     #                  #    #   #
#             #              #     #    #    #     #                  #    #   #
#####    #    #              #     #    #    #                        #    #   #
#        #    ##    ######## #     #    #    #                        #    #   #
#        #           #       #     #         #   ## ###    ########## #    #   #
#        #           #       #     #         #                        #    #   #
#   #    #                                   #     #                  #    #   #
#   #    #                                   #     #                  #    #   #
#        #                                                            #    #   #
######    ########################################################### #    #   #
#                 #      #                                            #    #   #
#                 #      #                                            #    #   #
#                 #      #       *                                    #    #   #
#                 #      #                                            #    #   #
#                 #      #                                            #    #   #
#                 #      #                                            #    #   #
#   ############# #      ##############    ###########################         #
#       #         #   ## #                         #                           #
#                 #      #                         #                           #
#                 #      #                         #                           #
#                                                                     #    #   #
#                             #                                  #    #    #   #
#       #                     #########    ########              #    #    #   #
#       #                     #                                  #    #    #   #
#                        #    #                    ###########    ### #    #   #
################    #### #    #                    #     #            #    #   #
#                        #    #                    #                  #    #   #
#                        #####    ################ #                  #    #   #
#                        #                         #                  #    #   #
#                        #                         #                  #    #   #
#               #        #                         #     #            #    #   #
################################################################################
