80 80
################################################################################
#   #    #    #    #     #           #    #         #     #             #      #
#   #    #    #    #     #           #    #         #     #             #      #
#   #    #    #    #     #           #    #         #     #             #      #
#   #    #    #    #     #           #    #    #    #     #        #    ###    #
#   #    #    #    #     #           #    ######     ##   #        #    #      #
#   #    #    #    #     #####    ## #    #                        #    #      #
#   #    #    #    #     #           #                             #    #      #
#   #    #         #     #           #                             #           #
#   #    #         ###   #           #         #    #              #           #
#   #    #         #     #           #         #    #     #        #           #
#   #    #         #     #    ####        #    #    #     #        #########   #
#   #    #    #    #     #    #           #    #    #     #        #       #   #
#   #    #    #    #     #    #           #    #    #     #        #       #   #
#   #    #    #    #     #    #           #    #    #     #        #       #   #
#   #    #    #    #     #    #      #    #    #    #     #        #       #   #
#   #    #    #    #     #    #      #    #    #    #     #        #       #   #
#   #    #    #    #     #    #      #    #    #    #     #        #       #   #
#   #    #    #    #     #    #      #    #               #        #    ###    #
#   #    #    #    #     #    #      #    #    ########## #####    #           #
#        #    #    #     #    #      #    #         #     #        #           #
#        #    #    #          #      #    #               #        #           #
#        #####     #          #      #    #               #        #           #
#        #    #    #          #      #    #               #                    #
#   #    #    #    #          #      #    ##    ####      ##################   #
#   #    #    #    #     #    #      #    #         #     #    #           #   #
#   #    #    #    #     #    #      #    #         #     #    #           #   #
#   #         #    #     #    #      #    #         #     #    #           #   #
#   #         #    #     #    #      #              #     #    #               #
#   #         #    #                 ##############    ## #    #               #
#             #    ###############   #          #         #    #               #
#   #### #         #    #            #          #         #    ###    ##########
#   #    #         #    #            #          #         #    #               #
#   #    #         #    #            #                    #    #               #
#   #    #         #    #            #                    #    #               #
#   #    #    #    #    #            #                    #    #        #      #
#   #    #    #    #                 #                    #    #        #####  #
#   #    #    #    #                 #                    #    ######   #      #
#   #    #    #    #                                      #    #        #      #
#   #    #    #    #######################    ########### #    #        #      #
#   #    #    #    #                                      #    #        #      #
#   #    #    #    #                                      #             #      #
#   #    #    #    #                                      #             #      #
#   #    #    #                                           #             #      #
#        #    #                                           #                    #
#        #    #     ####################################    ####################
#        #    #         #     #       #                                        #
#        #    #    #    #     #       #                                        #
#   #    #    #    #    #     #                                                #
#   #    #    #    #    #     #                                                #
#   #    #    #    #    #     #                                                #
#   #    #    #    #    #     #                                                #
#   #    #    #    #    #                                                      #
#   #    #    #    #    #                                                      #
#   #    #    #    #    #      ############    #################################
#   #    #    #    #    #              #                 #               #     #
#   #    #    #    #    #    ##        #                 #               #     #
#   #    #    #    #    #     #        #                 #               #     #
#   #    #    #    #    #     #        #                 #               #     #
#   #    #    #    #          ####     #    #############       #        ####  #
#   #    #    #    #          #        #                        #        #     #
#   #    #    #    #          #                                 #              #
#   #    #    #    #          #                                                #
#        #         #    #     #                          #########    ###      #
#######    ####### #    #     #   ###################### #       #             #
#     #    #       #    #     #                          #               #     #
#     #    #       #    #     #                          #               #     #
#                  #    #     #                          #               #     #
#                  #    #     #                                          #     #
##                 #    #     #####    ################################# #     #
#               ## #    #     #        #         #                       #     #
#     #    #       #    #     #        #         #                       #     #
#     #    #       #    #     #                                          #     #
#     #    #       #####      #                                          #     #
#     #    #       #    #     #                   ####################   #     #
#     ###    ##### #    #     ###############                            #     #
#     #            #          #                  #                       #     #
#     #            #      *   #                  #                       #     #
#     #            #          #                  #                       #     #
################################################################################
