80 80
################################################################################
#        #      #           #      #     #           #        #      #    #    #
#        #      #           #      #     #           #        #      #    #    #
#        #      #      #    #      #     #           #        #      #    #    #
######   #   ## #      #    #      #     #      #    #               #         #
#   #    #      #      #    #      #     #      #    #               #         #
#   #    #      #      #    #      #     #      #    #               #         #
#   #    #      #      #    #      #     ###    #    #               #         #
#   #    #      #      #    #      #     #      #    #        #      #    #    #
#   #    #      #      #    #      #     #      #    #        #   ## #    ###  #
#   #    #      #      #    #    ##      #      #    #        #      #    #    #
#   #    #      #      #    #            #      #    #        #           #    #
#   #    #      #      #    #            #      #    #        #           #    #
#   #           #      #    #            #      #    #        #                #
#               #      #    #      #     #      #    #        #       #######  #
#               #      #    #      #     #           #        #      #         #
#               #      #    #      #     #########   #        #      #         #
#        #      #   ## #    #######      #      #    #        #      #         #
#        #      #      #    #    #       #      #    #        #      #         #
######    ##### #      #    #    #       #      #    #        #                #
#   #           #      #    #    #       #      #    #        ########    ######
#               #      #                 #      #    #        #    #      #    #
#               #      #                 #      #    #        #    #      #    #
#        #             #                 #      #    #        #    #      #    #
#        #             #                 #      #    #        #    #      #    #
#   #    #             #                 #      #    #        #    #      #    #
#   #    #             ##########    ### ##     #    #        #    #      #    #
####     #      #      #           #     #      #    #        #    #      #    #
#        #      #      #      *    #     #      #    #        #    #      #    #
#        #      #      #           #     #      #    #        #    #      #    #
#        #      #      #           #     #      #    #        #    #      #    #
#        #             #    ###### #     #      #    #        #    #      #    #
######    ############ #    #      #     #      #    #        #    #   ## #    #
#   #    #             #    #      #     #      #             #    #      #    #
#   #    #             #    #      #     #      #             #    #      #    #
#   #                  #    #            #                    #    #      #    #
#   #                  #    ##                             ## #    #      #    #
#   #         #        #                             #        #    #      #    #
#   #         #        #                             #        #    #      #    #
#   #    #    #        #           #            #    #        #    #      #    #
#   #    #    #        #           #     #      #    #        #    #      #    #
#   #         #        #           #     #      #    #        #    #      #    #
#        #### #        #                             #        #    #      #    #
#             #        ########    ################# #        #    #      #   ##
#             #        #       #                     #        #    #      #    #
#             #        #       #                     #        #    #      #    #
#             #        #       #                     #        #    #      #    #
###########   #        #                             #        #    #      #    #
#        #    #        #                             #        #    #      #    #
#        #    #        #                             #        #    #      #    #
#        #    #        #                             #        #    #      #    #
#        #    #        #       #                     #        #    #      #    #
####     #    #        #       #                              #    #      #    #
#   #    #    #        #####    ############################# #    #      #    #
#   #    #    #        #                     #                #    #      #    #
#   #    #    #        #                     #                #    #      #    #
#        #    #####    #                     #                #    #           #
#             #        #                     #                #    #           #
#             #        #                     #                #    #           #
#             #        #                                      #    #           #
#             #        #                                      #    #      #    #
#                                                             #    #      #    #
#########    ################################################ #    #      #    #
#                #              #             #               #    #      #    #
#                #                            #               #    #      #    #
#                #                            #               #    #      #    #
#                #                            #               #    #      #    #
########    #### #######    ####                              #    #      #    #
#                               #                             #    #      #    #
#                               #                             #    #      #    #
#                               #                             #    #           #
#                               ##############    ########### #    ##    #######
#                #              #     #                       #    #           #
##################    ######### #     #                       #    #           #
#     #                         #                             #    #           #
#                               #                             #          #     #
#                               #                             #          #     #
#                               #                             #          #     #
#                               #     #                       #          #     #
################################################################################
