80 80
################################################################################
#    #                         #                                               #
#    #                                                                         #
#    #                                                                         #
#    #                                                                         #
#    #                                                                         #
#    ###############    ########################################################
#    #                #                   #     #    #      #     #    #       #
#    #                #                   #     #           #     #    #       #
#    #                #                   #     #                 #    #       #
#    #     #          #                   #     #                 #    #       #
#    #     #          #    ############## #     #            ##   #    #       #
#    #     #          #             #           #    #            #    #       #
#    #     #          #             #           #    ###### #          #       #
#    #                #             #           #     #     #          #       #
#    #######    ######                          #     #     #          #       #
#    #    #     #                         #     #     #     ####    ## #       #
#    #    #     #      #########          #     #     #     #          #       #
#    #    #     #           #             ##    #     ###   #          #       #
#    #    #     #     #     #       #     #     ###         #          #       #
#    #    #     #     #             #     #     #           #          #       #
#    #    #     #     #             #     #     #           #     #    #       #
#    #    #           #                         #           #     #    #       #
#    #    #           #######################   #     #     #     #    #       #
#    #    #           #    #      #       #     #     #     #     #    #       #
#    #    #           #    #      #       #     #                      #       #
#    #    #     #     #    #      #       #     #    ################# #       #
#    #          #     #    #      #             #    #           #     #       #
#    #          ###   #    #      #             #    #                 #       #
#    #     ##   #     #    #      #             #    #                 #       #
#    #          #     #    #      #####    #### #    #                 #       #
#    #    #     #     #    ####   #             #    #                 #       #
#    #    #     #     #    #      #             #    #           #     #####   #
#    #    #     #     #    #      #             #    #           #     #       #
#    #    #     #     #    #      #             #    #                 #       #
#    #    #     #     #    #      #             #    ####    ######### #       #
#    #    #     #     #    #      #    #        #    #          #              #
#    #    #     #     #    #      #    #        #                              #
#    #    #     #     #    #      #    #        #                              #
#    #    #     #     #           #    #        #                              #
#    #    #     #     #           #    #        #                              #
#    #    #     #     #           #    #        ############################   #
#    #    #     #     #           #    #        #         #      #      #      #
#    #####      #     #    #      #    #        #         #      #      #      #
#    #          #     ######      #    #        #         #      #      #      #
#    #          #     #     #     #    #        #         #      #      #      #
#    #          #     #     #     #    #        #    #    #      ####   #      #
#    #          #     #     #          ####     #    #    #      #      #      #
#         #     #     #     #          #        #    #    #      #      ####   #
#         ###   #     #     #          #        #    #    #      #      #      #
#         #     #     #     ##         #        ###    ### ###   #      #      #
#         #     #     #     #     #    #        #                #      #      #
#    #    #     #     #           #    #        #                #             #
#    #    #     #     #           #    #        #                #             #
#    #                                          #                #             #
#    ############    ########################## #    ########### #             #
#    #    #    #         #       #        #     #    #    #      ########    ###
#    #    #    #                 #        #     #    #    #      #      #      #
#    #    #    #                 #        #     #    #    #      #      #      #
#    #    #    #                 #        #     #    #    #      #      #      #
#    #         #                          #     #         #      #      #      #
#    #         #                          #     #         #      #      #      #
#    #         ####    ########## #####         #         ##     #      #      #
#    #               #                          #         #      #      #      #
#    #    #          #           #              ###    ## #      #      ####   #
#    #    #                      #              #    #    #      #      #      #
#    #    #                      #              #    #    #      #      #      #
#    #    #    #   ## #######    ######    #### #    #    #      #      #      #
#    #    #    #                 #              #    #    #      #      #      #
#    #    #    #     #           #                   #    #      #             #
#    #    #    #     #           #                   #    #      #             #
#    #    #    #                                     #    #      #    ##       #
#    #    #    ##    ###########################     #    #      #             #
#    #    #    #                                #    #    #      #      #      #
#    #         #                                #    #    #      #      #      #
#    ######    #                                #    #                  #      #
#    #         #             #*                 #                       #      #
#    #         #             #                  #                       #      #
#    #         #             #                  #                       #      #
################################################################################
