80 80
################################################################################
#   #         #    #          #                #      #              #     #   #
#   #         #    #          #                #      #              #     #   #
#   #         #    #          #                #      #     #        #     #   #
#   #         #    #     #    ###########    ##       #     ######   #     #   #
#   #         #    #     #    #        #              #     #        #     #   #
#   #              ######     #        #              #     #        #     #   #
#   #              #     #    #        #              #     #        #     #   #
#   #              #     #    #        #       #      #              #         #
#                  #          #        #       #      ##########     #         #
#             #    #                           #      #        #     #   ##    #
#             #    #                           #      #        #     #         #
#             #    #                           #      #              #     #   #
#   #         #    ##############    ######### #      #              #     #   #
#   #         #    #      #    #    #     #    #      ######    ##   #     #   #
#   #         #    #      #    #    #          #      #              #         #
#   ####      #    #           #    #          #               #     ########  #
#   #         #    #           #    #          #               #     #     #   #
#   #         #    #           #    #          #               #     #     #   #
#   #         #    #           #    #          #                     #     #   #
#   #         #          ##### #    ####    ## ###########    ###### #     #   #
#   #         #                #    #     #    #     #      #        #     #   #
#   #         #                #    #     #    #     #      #        #     #   #
#             #                #    #     #    #     #      #        #     #   #
##########    #    #      #    #    #     #    #     #      #        #     #   #
#      #      #    #      #         #     #    #     ####            #     #   #
#      #      #    #      #         #     #    #     #               #     #   #
#      #      #    #   ## #         #     #    #     #               #     #   #
#      #      #    #      #         #     #    #     #       #####   #     #   #
####   #      #    #      #    #    #     #    #     #      #        #     #   #
#      #      #    #      #    #    #     #    ##           #        #     #   #
#      #      #    #      #    #    #     #    #            #        #     #   #
#      #      #    #      #    #    #     #    #            #        #     #   #
#      #      #    #                #          #            #        #     #   #
#      #      #    #    ############           #     #      #        #     #   #
#      #      #    #                           #######      #        #     #   #
#      #      #    #                           #            #        #     #   #
#      ####   #    #                      #    #            #        #     #   #
#      #      #    #                      #    #            #        #     #   #
#             #    #                                                 #     #   #
#             #    ####    ######################################### #     #   #
#             #    #         #        #                       #      #     #   #
#             #    #         #        #                       #      #     #   #
#             #    #         #        #                       #      #     #   #
#             #    #         #        #                       #      #     #   #
############    ## #         #        #                              #     #   #
#         #        #   ##### #        #                              #     #   #
#         #        #         #        #                              #     #   #
#         #        #         #        ################    ########## #     #   #
#                  #         #        #              #     #               #   #
#    #             #         #        #              #     #               #   #
##   #             #         ###      #              #                     #   #
#    #             #         #        #              #                     #   #
#    #    #        #                  #   ### #      #               #     #   #
#    #    #        #                  #       #      #               #     #   #
#    #    #        #                  #       #      #               #     #   #
#    #    #        #                  #       #      #    ########## #     #   #
#    #    #        #         #        #       #   ## #        #      #     #   #
#    #    #        #         #        #       #               #      #     #   #
#####     #        ########    ###### #       #               #      #     #   #
#    #    ####     #      #           #       #               #      #     #   #
#    #    #        #      #           #       #               #      #     #   #
#         #        #      #           #              #        #      #     #   #
#         #        #      #                 ######## ##    ## #   ## #     #   #
#         #        #      #                          #               #     #   #
#         #        #                                 #               #     #   #
#         #        #                                 #               #     #   #
#                                                                    #         #
#   ################################################################ #         #
#                                        #                           #         #
#                                        #                           #         #
#                                        #                           #     #   #
#                                        #                           #    *#   #
#                                        #                           #     #   #
################    #################### #                           #     #   #
#                                        #####    ################## #     #   #
#                                        #                           #     #   #
#                                                                    #     #   #
#                                                                    #     #   #
################################################################################
