80 80
################################################################################
#       #        #         #     #        #          #    #       #       #    #
#       #        #         #              #          #    #       #       #    #
#       #        #                        #          #    #       #       #    #
#       #        #                        #          #    #               #    #
#       #        #                        #     #    #    #               #    #
#       #        #    ########## #        #     #         #               #    #
#   ### #####    #      #        #        #     #         #               #    #
#       #        #               #        #     #         #       #       ##   #
#       #        #               #        #     #         #       #       #    #
#       #        #               #        #     #    #    #       #       #    #
#       #        #               #              #    #    #       #       #    #
#       #        #   ## #        #              #    #    #       #       #    #
#       #        #      #        #              #    #    #       #       #    #
#       #        #      #        #              #    #    #       #       #    #
#       #        #      #        #        #     #    #    #       #       #    #
#       #        #      #        #        #     #    #    #       #       #    #
#       #        #      ####     #        #     #    #    #       #       #    #
#                #      #        #        #     #    #    #       #       #    #
#                #      #        #        #     #    #    #       #       #    #
#                #      #        #        #     #    #    #       #       #    #
###    ######### #      #        #        #     #    #    #       #       #    #
#      #    #    #      #        #        #     #    #    #       #       #    #
#      #    #    #      #        #        #     #    #    #       #       #    #
#      #    #    #      #        #   #### #     #    #            #       #    #
#      #    #    #      #        #        #     #    #            #       #    #
#   ## #    #    #      #        #        #     #    #            #       #    #
#      #    #    #      #        #        #     #    #            #       #    #
#      #    #    #      #        #        #     #    #    #       #       #    #
#           #    #      #        #        #     #    #    #       #       #    #
#           #    #      #        #        #     #    #    #       #       #    #
#           #    #      #        #        #     #         #       #       #    #
###    #####            #        #        #     #    #### #       #       #    #
#                       #        #        #     #    #    #       #       #    #
#                       #        #        #     #         #       #       #    #
#                       #        #        #     #         #       #       #    #
#                                #        #     #         #       #       #    #
#   ############################ #        #     #         #       #       #    #
#        #            #     #    #        #     #    #    #       #            #
#        #            #     #    #        #     #    #    #       #            #
#        #            #          #        #          #    #       #            #
#        #            #          #        #########    ## #       #            #
#   #    #   ######## #          #        #    #     #    #       #       #    #
#   #    #     #       #######   #        #    #     #    #       #    ## #    #
#   #    #     #           #     #        #    #     #    #    *  #       #    #
#   #    #                       #        #          #    #       #       #    #
####     #                       #        #          #    #       #       #    #
#        #                       #        #          #    #       #       #    #
#        #                       #        #          #    #       #       #    #
#        ###    ################ #        #    #     #    #####   #       #    #
#                                #        #    #          #       #       #    #
#   #                            #        #               #       #            #
#   #                            #        ########        #       ##    ########
#                                         #               #       #      #     #
##########    ########################### #          #    #       #      #     #
#            #                            #          #    #       #      #     #
#            #                            #     #    #    #       #      #     #
#            #                            #     #    #    #       #    ##    ###
#            #                            ###   #    #    #       #            #
#                                         #     #    #    #       #            #
#                                         #     #    #    #       #            #
#                                         #     #    #    #                    #
#                                                         ##    ################
##    ################################################### #            #       #
#               #                                         #            #       #
#               #                                         #            #       #
#                                                         #       #    #       #
#                                                         #       #    #       #
#                                         ############    #       #    #       #
#                                         #         #     #            #       #
#                                         #         #     ####    #### #       #
#                                         #         #     #            #       #
#################    #################### #         #     #            #       #
#                #                        #         ##    #            #       #
#                #                        ####      #     #            ##    ###
#                #                        #         #     ###     ##           #
#                                         #               #      #             #
#                                         #               #      #             #
#                                         #               #      #             #
################################################################################
