80 80
################################################################################
#   #         #        #                    #                                  #
#   #         #        #                    #                                  #
#   #         #        #                    #                                  #
#   #         #        #                                                       #
#   #         #        #                                                       #
#   #         ######   #                                                       #
#   #                  #                                                       #
#   #                  #################################################    ####
#   #                  #                          #        #       #    #      #
#   #                  #                          #        #       #    #      #
#   ####      #        #                          #        #       #    #      #
#   #         #        #                          #        #            #      #
#   #         #        #                          #        #            #      #
#   #         #        ###########    ########### #        #            #      #
#   #         #        #    #     #    #     #    #        #########    #      #
#   #         #        #    #     #    #          #        #       #    #      #
#   #         #        #    #     #    #          #        #       #    #      #
#             #        #    #     #    #          #        #       #    #      #
#             #        #    #     #    #          #        #       #    #      #
#             #        #    #     #    ##    #    #        #       #    #      #
#             #        #    #     #    #     #    #        #       #    #   ####
#   #         #        #    #     #    #     #    #        #       #    #      #
#   #         #        #    #     #    #     #    #        #       #    #      #
#             #        #    #     #    #     #    #        #       #    #      #
#####    #### #        #    #     #    #          #        #       #    #      #
#       #     #        #    #     #    #######    #        #       #    #      #
#       #     #        #    #     #    #     #    #        #       #    #      #
#       #     #        #    #     #    #     #    #        #       #    #      #
#       #     #        #    #          #     #    #        #       #    #      #
#       #     #        #    #          #     #    #        #       #    #      #
#       #     #        #    #          #     #    #        #       #    #      #
##      #     #        #     ###    ## #     #    #        #       #    #      #
#       #     #        #          #    #          #        #       #    #      #
#             #        #          #    #          #         ####   #    #      #
#             #                   #    #          #                #    #      #
#             #             #     #    #          #                #    #      #
#             #             ##    #    #     #    #                #    #      #
#                           #    *     #     #    #        #       #    #      #
#    ################# #    #          #     #    ###      #       #    #      #
#    #       #    #    #    #          ##    #    #        #       #    #      #
#    #       #    #    #               #     #             #       #    #      #
#    #       #    #    #   ########### #     #             #       #    #      #
#    #       #    #    #       #             #             #       #    #      #
#            #    #    #       #             #             #       #    #      #
#            #    #    #       #             #    #        #       #    #      #
#            #    #    #       #             #    #        #                   #
#            #    #    #       #       #     #    #        #                   #
#    #       #    #    #       #       #     #    #        #                   #
#    #       #    #    #       #       #     #    #        #                   #
#    #       #         #       #       #     #    #        #       #    #      #
#    #                 #       #       #     #    #        #       #    #      #
#    #                 #       #       #     #    #        #       #    #      #
#    #                 #       #       #     #    #        #       #    #      #
##   #            #    #       #       #     #    #        #       #           #
#    #       #    #    #       #       #     #    #        ########    #########
#    #       #    #    #       #       #     #    #        #             #     #
#    #       #    #    #       #       #     #    #        #             #     #
#    #       #         #       #       #     #    #        #             #     #
#    #       #######   #       #       #     #    #        #             #     #
#    #       #    #    #       #       #     #    #        #             #     #
#    #       #    #    #       #       #     #    #        #########    ##   ###
#    #       #    #    #       #       #     #    #        #       #           #
#    ####    #    #    #       #       #     #    #        #       #           #
#    #       #    #    #               #     #    #        #                   #
#    #       #    #    #               #     #    #        #                   #
#    #       #    #    #               #     #    #        #                   #
#    #       #    #    #               #     #    #########    #################
#    #       #    #    #       #       #     #    #             #          #   #
#    #       #    #    #       #       #     #    #                            #
###    ##### #    #    #       #       #     #    #                            #
#            #    #    ###     #       #     #    #                            #
#            #    #    #       #       #     #    #                  #         #
#            #    #    #       #       #     #    #             #    #         #
#            #    #    #       ####    #     #    ##########    #### #         #
##   #   ### #    #    #       #       #     #    #        #         ##    #####
#    #       #    #    #       #       #     #    #                  #         #
#    #       #         #       #       #     #    #                  #         #
#    #       #         #       #       #     #    #                  #         #
################################################################################
