80 80
################################################################################
#     #                 #            #      #        #            #    #       #
#                                    #      #        #            #    #       #
#           #                        #               #            #    #       #
#           #                        #               #       #    #    #       #
#           ##    ################## #                       #         #       #
#     #     #                        #                       #         #       #
#     #     #                        #      #                #         #       #
#     #     #                        #      #                #         #       #
#     #                              #      #####    ####### #    #    #       #
#     #   ########################## #      #           #    #    #    #       #
#     #                       #      #      #           #    #    #    ####    #
##    #                       #      #      #           #    #    #    #       #
#     #                       #      #      #      #    #    #    #    #       #
#     #                              ###    #      #    #    #    #    #       #
#     #                              #      #      #         #    #            #
#     #                                     #      #         #    #            #
#                                           #      #         #                 #
#########################    ########       #####    ###     #   ######        #
#      #        #                           #           #    #         #       #
#      #        #                    #      #           #    #         #       #
#      #        #                    #      #           #    #         #       #
#      #        #      #             #      #           #    #         #       #
#               #      #             #      #      #    #    #    #    #       #
#               #      #             #      #      #    #    #    #    #       #
#               #      #             #      #      #    #    #    #    #       #
#               #                    #                       #    #    #       #
#      #        ##############    ## ##########    ######### #    #    #       #
#      #        #      #             #      #     #    #     #    #    #       #
#      #        #      #             #      #     #    #     #    #    #       #
#      #        #      #             #      #     #    #     #    #    #       #
#      #        #      #     #       #      #     #    #     #    #    #       #
#      #        #      #     #####   #      #     #    #     #    #    #       #
#      #        #      #     #       #      #     #    #     #    #    #       #
#      ##    ## #      #     #       #      #     #    #     #    #    #       #
#      #        #      #     #       #      #     #    #     #    #    #       #
#      #        #      #             #       ##   #    #     #    #    #       #
#      #        #      ###########   #            #    #     #    #    #       #
#      #        #      #       #     #            #    #     #    #    #       #
#      #        #      #       #     #            #    #     #    #    #       #
#      #        #      #       #     #      #     #          #    #    #       #
#      #        #      #       #     #      #     #          #    #    #       #
#  ### #        #      #       #     ###    #                #    #    #       #
#      #        #      #       #     #      #                #    #    #       #
#      #        #      #       #     #      #          #     #    #    #       #
#      #        #      #       #     #      #          #     #    #    #       #
#      #        #      #       #     #      #     #    #     #    #    #       #
#      #        #      #       #     #      #     #    #     #    #    #       #
#      #        #      #       #     #      #     #    #     #    #    #       #
#      #        #      #       #     #      #     #    #     #    #    #       #
#      #        #      #       #     #      #     #    #     #                 #
#      #        #      #       #     #      #     #          ###########    ####
#               #      #       #     #      #     #######    #                 #
###########     #              #     #            #     #    #                 #
#       #       #              #     ##########   #     #    #                 #
#       #       #              #     #      #     #     #    #                 #
#       #       #                    #            #     #    #       #         #
#       #       #      #             #            #          #       #         #
####    #       #      #             #            #          #       #         #
#       #       #      #             #                               #         #
#       #       #      #       #     ##############################    #########
#       #       #      #       #     #                             #      #    #
#               #      #       #     #                             #      #    #
#               #      #       #     #                             #      #    #
#        ##     #      #       #     #                             #      #    #
#               #      #       #     ################    ######### ####   #    #
#       #       #      ##      #     #            #      #                #    #
#       #              #       #     #            #      #                     #
#       #              #       #     #            #                            #
#       #              #       #     #       #                                 #
#       #              #       #     #       #                     ####    #####
#       #       #      #       ##    #       #                     #       #   #
#       #       #      #       #     #                   #         #       #   #
#       #       #      #       #     #    ####### #      #         #           #
#       #       #      #       #     #       #    #                #           #
#       #       #      #       #     #       #    ##    ########## ###         #
#       #       #      #       #     #       #    #                #           #
#       #       #      #       #    *#            #                #       #   #
#       #       #      #       #     #            #                #       #   #
################################################################################
