80 80
################################################################################
#   #     #    #      #     #             #    #                          #    #
#         #    #      #     #             #    #                          #    #
#         #    #      #     #             #    #                          #    #
#         #    #      #                   #    #               #          #    #
#         #    #      #                   #    #               ########   #    #
##    ### #    #      #                   #    ######    ##### #    #     #    #
#   #     #    #      ############    ####     #               #          #    #
#   #     #    #      #                        #               #          #    #
#   #     #    #      #                        #               #          #    #
#   #          #      #                        #                          #    #
#   #          #      #                        #    ##################### #    #
#   #          #      #                        #       #     #    #       #    #
#   #          #      ############    ######## #       #     #    #       #    #
#   #     #    #      #     #       #     #    #       #     #    #       #    #
#   #     #    #      #     #       #     #    #       #     #    #       #    #
#   #     #    #      #     #       #     #    ##      #                  #    #
#   #     #    #      #     #       #     #    #       #                  #    #
#   #     #    #      #     #       #     #    #       #                  #    #
#         #    #      #     #       #     #    #       #                  #    #
#         #    #      #     #       #     #    #       #     #    #    ## #    #
#         #    #      ###   #       #     #    #             #    #       #    #
#         #    #      #             #     #    #             #    #       #    #
#   #     #    #      #             #     #                  #    #       #    #
#   #     #    #      #         ### #     #     ##########   #    #       #    #
#   #     #    #      #             #               #        #    #       ###  #
#   #     #           #     #       #               #        #    #       #    #
#   #     #           #     #       ##         #    #        #    #       #    #
#   #     #           #     #       #          #    #        #    #       #    #
#   #     #           ####    ##### #     #    #    #        #    #       #    #
#   #     #    #      #        #    #     #    #             #    #       #    #
#   #     #    #      #        #    #     #    #             #    #       #    #
#   #     #    #      #        #    #     #    #     #####   #            #    #
#   #     #    ##     #        #    #     #    #             #########    #    #
#   #     #    #      #        #    #          #    #        #      #     #    #
#   #     #    #      #        #    ##    #### #    #        #      #     #    #
#   #     #    #      #        #    #    #     #    #        #      #     #    #
#   ##    #    #      #        #    #    #     #    #        #      #     #    #
#   #     #    #      #        #    #    #     #    #        ####              #
#   #     #    #      #        #    #    #     #    #        #                 #
#   #     #    #               #    #    #     #    #        #                 #
#   #     #    #               #    #    #     #    #        #                 #
#              #           ### #*   #    #     #             #                 #
############   #               #    #    #     ############    #################
#    #    #    #      #        #    #    ##    #              #                #
#    #    #    #      #        #    #    #     #              #                #
#    #    #    #      #             #    #     #              #                #
#    #    #    #      #             #          #              #                #
#    #    #    #      #                        ###    ########                 #
#    #    #    #      #                        #        #                      #
#    #    #    #                               #        #      #############   #
#    #    #    #########    ################## #        #          #     #     #
#    #    #    #                               #        #     #    #     #     #
#         #    #                               #   #### #     #          #     #
#         #    #                               #        #     #                #
#         #    #                               #        #     #                #
#         #    #                               #        ###   #                #
#    #    #    #   #### #######    ########### #        #     ########       ###
#    #    #    #        #                      #        #     #          #     #
#    #    #    #        #                      #              #          #     #
#    #    #    #        #                      #              #          #     #
#    #    #    #                                                               #
#    #    #    ##############################################################  #
#    #    #    #                                                               #
#    #    #    #                                                               #
#    #    #    #                                                               #
#    #    #    #              #                                                #
#    #    #    #         #    #                                                #
#    #    #    #         #                                                     #
#    #    #    #         ###################################################   #
#    #    #    #         #     #                                               #
#    #    #    #         #     #                                               #
#    #    #    #         #     #                                               #
#    #    #    #         #     #                                               #
#    #    #    #         #    ###################    ###########################
###    ## #    ####      #                                                     #
#              #         #                                                     #
#              #         #                                                     #
#              #         #                                    #                #
################################################################################
