80 80
################################################################################
#        #         #     #                         #        #      #     #     #
#        #         #                               #        #      #           #
#        #         #                               #        #      #           #
#        #         #                 #             #        #      #      ###  #
###    ## ###      #   ##            #             #        #      #           #
#                  #     #           #             #        #      #     #     #
#                  #     #           #             #        #      #     #     #
#                  #     ##########    ########### #        #      #     #     #
#                  #     #                         #        #      #     #     #
#                  #     #                         #        #      ######    ###
####    ########## #     #                         #        #      #     #     #
#   #       #      #                               #        #      #     #     #
#   #       #      ###################    ######## #        #      #     #     #
#   #       #      #    #         #    #           #        #      #     #     #
#   #       #      #    #         #    #           #        #      #     #     #
#   #       #           #         #    #           #        #      #     #     #
#           #           #         #                #        #      #     #     #
#           #           #         #                #               #     #     #
#       ### #           #    #### #                #               #     ###   #
#           #      #              #                #               #     #     #
#   #       #      #              #                #               #     #     #
#   #       #      #              ##########    ## #        #      #     #     #
#   #       #      #              #       #        #        #      #     #     #
#   #       ####   #    #    #    #       #        #        #      #     #     #
#   #       #      #    #    #    #       #        #        #      #     #     #
#   #       #      #              #       #        #        #      #           #
#   #       #      ######    #####        ###      #        #      #           #
#   #       #      #                      #        #        #      #           #
#           #      #               ##     #        #        #      #           #
#######    ##      #                      #        #        #      #     #     #
#                  #              #                #        #      #     #     #
#                  #       #      #                #####    #      #     #     #
#                  #       #      #                #        #      #     #     #
#                                 #                #        #      #     #     #
################################    ############## #        #      #     #     #
#                                           #      #        #      #     #     #
#                                           #      #        #      #     #     #
#                                           #      #        #      #     #     #
#                                           #      #        #      #     #     #
#################    ###################### #      #        #            #     #
#      #                        #           #      #        #            #     #
#      #                        #           #      #        #            #     #
#                               #           #      #        #            #     #
#                               #    #      #      #               #     #     #
####    ###############    #### #    #      #      #############   #     #     #
#                               #    #      #      #       #       #     #     #
#      #                        #           #      #       #       #     #     #
#      #                        #########   ####   #               #     #     #
#                               #     #     #      #               #     #     #
##########################      #     #     #      #               #     #     #
#               #     #         #     #     #      #                     #     #
#                     #         #     #     #      #####################    ####
#                     #         #     #     #      #        #       #          #
#                     #         #     #     #      #        #       #          #
#                     #    #    #     #     #               #       #          #
#                     #    #    ##    #     #               #                  #
#                     #    #    #     #     #               #                  #
##########    ####### ##    ### #     #                     #   #### #######   #
#       #       #     #         #     #            #        #                  #
#       #       #     #               #            #        #       #          #
#       #       #     #               #            #                #          #
#       #       #     #               #     #      #                #    #     #
#       #       #     #               #     #      #                     #     #
#  #### #    ## #     #    #    #     #     #      #         ##########*   #####
#       #       #     #    #    #     #     #      #        #     #            #
#       #       #     #    #    #     #     #      #        #     #            #
#       #       #     #    #    #     ##    #      #        #     #            #
#       #             #    #    #     #     #      #        #     #            #
#       #             #    #    #     #     #      #        #     #        ##  #
#       #             #    #    #     #     #      #        #     ####    #    #
#       #             #    #    #     #     #      #    ### #     #       #    #
#       #             #    #    #     #     #      #        #             #    #
#       #             #    #    #     #     #      #        #             #    #
#       #    ######## #    #    #     #     #      #        #                  #
#       #        #    #    #    #           #      #        #   ## ########    #
#       #        #         #    #           #      #        #     #            #
#                          #    #           #      #        #     #            #
#                          #    #           #      #        #     #            #
################################################################################
