80 80
################################################################################
#              #     #      #          #    #      #      #      #     #       #
#              #     #      #          #    #      #      #      #     #       #
#              #     #      #          #    #      #      #      #     #       #
#              #     #      #    #     #           #      ####   #     #       #
#      #       #     ##     #    #                 #      #      ##    #   #####
#      #       #     #      #    #                 ###                 #       #
#      #       #     #      #    ##                #                   #       #
#  ### #       #     #      #    #          ##     #                           #
#      #       #     #      #    #     #    #      #                           #
#      #       #     #      #    #     #    #      #             #             #
#      #   ### #     #      #    #     #    #      #######    ## ########    ###
#      #       #     #      #    #     #    #      #    #        #         #   #
#      #       #     #      #    #     #    #      #    #        #         #   #
#      #             #      #    ###    ### #      #             #         #   #
#      #             #      #    #          #      #             #         #   #
#      #             #      #    #          #      #             ####      #   #
#      #             #      #    #          #      #         ### #         #   #
#      #       #     #      #    #          #      #    #        #             #
#      #       ##    #      #    #          #      #    #        #             #
#      #       #     #      #    #                 #    #        #             #
#      #       #     #      #    ############      #    #                      #
#      #       #     #           #    #     #      ###    ######################
#      #       #     #           #    #     #      #       #     #       #     #
#      #       #     #           #    #            #       #     #       #     #
#      #       #     #           #    #            #       #     #       #     #
#      #       #     #####    ## #                 #       #     #       #     #
#      #       #     #    #      #                 #       ###           #     #
#      #       #     #    #      #          #      #       #             #     #
#      #       #     #           #          #      #       #       *     #     #
#      #       #     #           #          #      #       #          ## #     #
#      #       #     #           #   ###### ####   #       #     #       #     #
#      #       #     #           #          #      #       #     #       #     #
#      #       #     #    #      #          #      #       #     #       #     #
#      #             #    #      #          #      #       #     #       #     #
#      ####    ##### #                             #       #     #       #     #
#      #        #     #################    ####### #       ######    ### #     #
#      #                     #    #                #       #    #        #     #
#      #                     #                     #       #    #        #     #
#      #                     #                     #       #    #        #     #
#      #             #       #                     #       #    #        #     #
#      #             #                 ########### #       #    #        #     #
#####    ########### #            #                #       #    #        #     #
#       #     #      #            #                #       #    #        #     #
#       #     #      #            #                #            #        #     #
#       #            #       #    #        #       #            #        #     #
#       #            #       #    #        #       #            #        #     #
##      #   ##       #       #    #        #       #            #        #     #
#       #            #       #                     #       #    #        #     #
#             #      #       ######    ########### #       #    #        #     #
#             #      ###     #              #      #       #    #        #     #
#             #      #       #              #      #       #    ###      ##    #
#             #      #       #              #      #       #    #              #
##    ####### #      #       #                     #       #    #              #
#   #         #      #       #        #            #       #                   #
#   #         ###    #       #        #            #       #                   #
#   #         #      #       #####    ########             #             #     #
#             #      #       #        #                    #             #     #
#             #      #       #        #                    #    #        #     #
#             #      #       #        #                    #    #        #     #
#             #                                    #       #    #        #     #
############    ################################## #       #             #     #
#                                 #       #        #       ##############    ###
#                                 #       #        #       #      #     #      #
#                                 #       #        #       #            #      #
#                            #    #       #        #       #            #      #
######    ################## #                     #       #                   #
#                            #                     #       #                   #
#                            #                     #       #      #            #
#                            #                     #       #      #            #
#                                 ######    ###### #       #      #            #
###############    ############## #         #      #       #      #            #
#                        #        #         #      #       #      #########    #
#                                 #                #       #      #            #
#                                 #                #       #      #            #
#                                 #####            ###     #   ## #            #
#                                 #                #       #      #            #
#                        #        #         #      #       #      #      #     #
#                        #        #         #      #       #      #      #     #
################################################################################
