80 80
################################################################################
#     #    #    #             #    #           #        #              #       #
#          #    #             #    #           #        #              #       #
#          #    #     #       #    #    #      #        #              #       #
#                     #       #    #    #      #        #         #### #       #
#                     #       #    #    #      #        #    #         #       #
##    #               #       #    #    #      #        #    #         #       #
#     ###    ###      #            #    #      #        #    #         #       #
#     #    #    #     #            #    #      #        #              #       #
#     #    #    #     #            #    #      #        #########      #       #
#     #    #    #     #            #    #      #   #### #    #         #       #
#     #    #    #     #####   #    #    #      #        #    #         #       #
#     #         #     #       #    #    #      #        #    #         #       #
#     #         #     #       #    #    #      #        #    #         #       #
#     #         #     #       #    #    #      #        #    #         #       #
#               #     #       #    #    #      #        #    #         #       #
#######    #### #     #       #         #      #        #    #         #       #
#   #    #      #     #       #         #      #        #    #         #       #
#   #    #      #     #       #         #      #        #              #       #
#   #    #      #     #       #         #      #        #              #       #
#               #     #       #    #    #      #        #              #       #
#               #     #       #    #    #      #        #              #       #
#               ###    ###### #    #    #      #        #    #         #       #
#    ########   #             #    #    #               #    #         #       #
#   #     #     #             #    #    #               #    #         #       #
#   #           #             #    #    #               #    #         #       #
#   #           #        #    #    #    #               #    #         #       #
#   #           #        #    #    #    #      #        #    #         #       #
#   #           #        #    #         #      #        #    #         #       #
#                        #    #    #### #      #        #    #         #       #
#########################     #    #    #               #    #         #       #
#           #                 #    #    #    ########## #    #         #       #
#                             #    #    #               #    ####      #       #
#                             #         #               #    #         #####   #
#                             #         #                    #                 #
#######      ##    ########## #                              #                 #
#           #     #           ##    ####################     #                 #
#           #     #           #                              #                 #
#           #                 #                         #    #                 #
#           #                 #                         #####    ###############
#                                                       #                  #   #
##################################################      #                  #   #
#       #              #    #                  #        #                  #   #
#       #              #    #                           #          #       #   #
#                      #    #                           #          #       #   #
#                      #                                #                  #   #
#                      #          #                     #######    ####### #   #
#        #######    ## #          #            #        #         #        #   #
#       #      #       #                       #        #         #        #   #
####    #      #            ###########    ### #        #         #        #   #
#       #      #            #      #           #        #    #    #        #   #
#       #      #            #                  #        #    #    ####     #   #
#       #   ## #   ####     #                  #        #         #        #   #
#       #              #    #                  #        #    #### #        #   #
#       #              #    #             #    #        #    #    #        #   #
#       #              #    #      #      #    #        #    #    #        #   #
#                      #    #      #           #        #    #    #        #   #
#  ################### #    #      #    ###### #        #    #    #        #   #
#                #     #    #      #      #    #        #    #    #        #   #
#                #     #    ##     #      #    #        #    #    #        #   #
#                      #    #      #      #    #        #    #    #        #   #
#                      #    #      #           #        #    #    #        #   #
#   #############      #    #      #           ###      #    #    #        #   #
#                      #    #      #           #        #         #        #   #
#                #     #                       #        #         #            #
#                #     #####################   #        #                      #
#           #    #     #                       #        #                      #
#           #    #     #                       #        #    #                 #
#           #    #     #                       #        #    #             #   #
#                                              #        #    #    #        #   #
######    #################################### #        #    #    #        #   #
#                           #                  #        #    #    #        #   #
#                           #                  #        #    #    #        #   #
#                        *  #                  #        #    #    #        #   #
#                           #                  #        #    #    #        #   #
###################    #### ################   #        #    #    #        #   #
#                                              #        #    #    #        #   #
#                                              #        #    #    #        #   #
#                                              #        #    #    #        #   #
################################################################################
