80 80
################################################################################
#                                   #       #                #         #       #
#                                                            #         #       #
#                                                   #        #         #       #
#       ##########    ##############                #        #    #### #       #
#      #                      #      ############   ######             #       #
#      #                      #     #               #                  #       #
#      #                            #               #                  #       #
#      #                            #               #             #    #       #
#      #                                            #             #    #       #
#      ###################    ##################### #                  #       #
#      #                #                           #   ############## #       #
#      #                                            #      #      #    #       #
#      #                                            #      #      #    #       #
###    #                                            #      #           #       #
#      #   ############# ######    ################ #                  #       #
#      #                #                           #                  ######  #
#      #                #                           #       ##    #### #       #
#      #                #                           #   ###       #    #       #
#                                                   #      #      #    #       #
##############    ################################# #      #      #    #       #
#                                                   #      #      #    #       #
#                                                   #      #           #       #
#                                                   #      #           #       #
#                                                                      #       #
################    ################################################## #       #
#    #    #    #    #            #      #        #               #     #       #
#    #    #    #    #            #      #        #               #     #       #
#              #    #            #      #        #               #     #       #
#              #    #            #      #        #               #     #       #
#              #    #####    ### #               ##    ######### ##    #       #
#              #    #      #     #               #                     #       #
#         #    #    #      #     #               #                     #       #
#  ###### #    #    #      #     #                                     #       #
#         #    #    #      #     #      #                              #       #
#         #    #    #      #     #      #                              #       #
#         #    #    #      #            #    #### ###############      #       #
#              #    #      ###          #        #               #     #       #
###########    #    #      #            #        #               #     #       #
#              #    #      #            #        #                     #       #
#              #    #      #     ####   #        #                     #       #
#              #    #      #     #      #                              #       #
#    #         #    #      #     #      ###    ####################### #       #
##   #   ##### #    #      #     #      #     #     #                  #       #
#    #         #    #      #     #      #     #     #                  #       #
#    #              #      #     #      #     #     #                  #       #
#    #              #      #     #      #           #                  #       #
#                   #      #     #      #           #       #          #       #
#################   #      #     #      #           #       #          #       #
#   #                      #     #      #           #       #          #       #
#   #                            #      #######    ##                          #
#   #                            #      #            ###########    ###        #
#   #                            #      #           *                          #
#   #        #      #            #      #                                      #
#   #        #      #      #     #      #                              #       #
#   #        #      #      #     #                                     #       #
#   ##    ## #      #      #     #################    ################ #       #
#   #        #      #      #     #         #               #    #      #       #
#   #        #      #      #     #         #               #           #       #
#   #        ####   #      #     #         #               #           #       #
#            #      #      #     #         #               #           #       #
#            #      #      #     #    #####    ########### #           #       #
#            #      #      #     #    #                    #    #      #       #
#            #      #      #     #                              #      #       #
#   #        #      #      #     #                              #      #       #
#   #        #      #      #     #                                     #       #
#   #               #      #     #                             ####### #       #
#   ###########     #      #     #####################    ##     #     #       #
#   #               #      #     #                         #           #       #
#   #               #      #     #                         #           #       #
#   #               #      #     #                         #           #       #
#   #        #      #                                      #           #       #
#   #        ###    #####################################    ######### #       #
#   #        #      #            #                                     #       #
#   #        #      #                                                  #       #
#   ####     #      #                                                  #       #
#   #        #      #                                                  #       #
#   #        #      #                                                  #       #
#   #        #      #            #                                     #       #
################################################################################
