80 80
################################################################################
#                                   #                             #    #       #
#                                   #                             #    #       #
#                                   #                             #    #       #
################    ############### #                             #            #
#           #      #         #      #    ## ###########    ###### #            #
#                  #                #       #                     #            #
#                  #                #       #                     #            #
#                  #                #       #                     #    #       #
#                  ####    ## ###   #                             #    #       #
#############      #         #       ########################     #    #       #
#   #              #         #           #       #                #    #       #
#   #              #         #                   #                #    #       #
#   #              #         #                                    #    #       #
#   #              #                #                             #    #       #
#        #         ###########      #                             #    #       #
#        #####    ##      #         #    #                        #    #       #
#        #    #                     #    #       ###########      #    #       #
######   #    #                     #            #                #    #       #
#        #    #                     ######    ## #                #    #       #
#        #                          #            #                #    ####    #
#        #         #      #         #            #         #      #    #       #
#        #         #      #         #            #         #      #    #       #
#                                   #                             #    #       #
##################################    ########################### #    #       #
#                                          #            #         #    #       #
#                                                       #         #    #       #
#                                                       #         #    #       #
#                                                       #    #    #    #       #
#                                                       #    #    #    #       #
#                                                       #    #    #    #       #
#  #################################################### #    #    #    #       #
#                                                  #    #    #    #    #       #
#                                                  #    #    #    #    #       #
#                                                * #    #    #    #    #       #
#    #                                             #    #    #    #    #       #
#    #                                             #    #    #    #    #       #
#    #                                             #    #    #    #    #       #
#    #                                             #    #    #    #    #       #
#    #                                             #    #    #    #    #       #
###    ########################################### #    #    #    #    #       #
#    #                                     #       #    #    #    #    #       #
#    #                                     #       #    #    #    #    #       #
#    #                                     #       #    #    #    #    #       #
#    #                                     #       #    #    #    #    #       #
#    ##########################    ####### ##      #    #    #    #            #
#    #                                     #       #    #    #    #########    #
#                                                  #    #    #    #            #
#                                                  #    #    #    #            #
#                                                  #    #    #    #            #
#################    ######################        #    #    #    #            #
#        #                                 #       #    #    #    #       #    #
#        #                                 #       #    #    #    #       #    #
#        #                                 #       #    #    #    #       #    #
#        #                #                #       #    #    #    #       #    #
#        ####    ######## ######    ###### #       #    #    #            #    #
#        #                #                #       #    #    #            #    #
#        #                #                #       #    #####             #    #
#        #                #                #       #    #                 #    #
#        #                                 #       #    #         #       #    #
#        ########    ##################### #       #    #         #       #    #
#        #       #             #           #       #    #         #       #    #
#        #       #             #           #       #    #         #       #    #
#        #       #             #           #       #    #    #    #       ##   #
#        #       #             #           #       #    #    #    #       #    #
#        #       #########      ##    #### #       #    #    #    #       #    #
#        #       #     #                   #       #    #    #    #       #    #
#        ###     #     #                   #       #    #    #    #       #    #
#        #       #                         #       #    #    #    ####    #    #
#        #       #             #     #     #       #    #    #    #       #    #
#        #       #             #     #     #       #    #    #    #       #    #
#        #       #                         #       #    #    #    #       #    #
#        #       ###############    ###### #       #    #    #    #       #    #
#        #                   #             #       #         #    #       #    #
#        #                   #             #       #         #    #       #    #
###      #                   #             #       #         #    #       #    #
#                                          #       #         #    #       #    #
#                #                         #            #    #    #       #    #
#                #                         #            #    #    #       #    #
################################################################################
