80 80
################################################################################
#                                    #     #       #                      #    #
#                                    #     #       #                      #    #
#                                    #     #       #     #       #        #    #
###############    ################# #     #       #     #       #        #    #
#                                    #     #       #     ######    ###### #    #
#                                          #       #     #                #    #
#                                          #       ###   #                #    #
#                                          #    ## #     #                #    #
#          #                               #       #     #     #          #    #
#          #                               #       #     #     #          #    #
#                                          #       #                      #    #
#####################    ##################        ##############    #### #    #
#             #                       #            #      #        #      #    #
#             #                                    #               #      #    #
#             #                                    #               #           #
#    #        #                            #       #               #           #
#    #        #                            #       ###     #####   #           #
#    #                                     #       #      #        #           #
#                                          #       #      #        #      #    #
###########    #########    ############## #       #      #        #      #    #
#                                          #       #               #      #    #
#             #                            #        #########      #      #    #
#             #                            #               #       #      #    #
#                                                          #       #      #    #
################################    ###############        #              #    #
#    #     #         #                             #       #              #    #
#    #     #         #                             #       ##    ##       #    #
#    #     #         #                             ##      #              #    #
#    #     #         #                             #       #       #      #    #
#    #     #                                       #               #      #    #
#    #     #                                       #               #      #    #
#    #     #                                       #                           #
#    #     #######################    ############ ###    ######################
#    #     #         #        #     #      #       #        #           #      #
#    #     #         #        #     #      #       #        #           #      #
#    #     #         #              #      #       #        #           #      #
#    #     #    #    #              #      #       #        #           #      #
#    #     #    #    #    ####      #      #       #        #           #      #
#    #     #         #              #   ## #       #        #           #      #
#    #     #    #### #        #            #       ####     ########    #      #
#    #     #    #    #        #            #       #        #           #      #
#    #     #    #    #        #            #       #        #           #      #
#    #     #    #    #        #            #       #        #           #      #
#    #     #    #    #        #     #              #        #                  #
#    #     #    #    #              #              #        #     #            #
#    #     #    #    ##########     #              #        #     #            #
#    #     #    #    #              #              #        #     #            #
#    #     #    #    #              #      #       #        #     #     #      #
#    #     #    #    #              #      #       #              #     #      #
#    #     #    #    #              #      #       #              #     #      #
#    #     #    #            #      #      ##      #              #     #      #
#    #     #    #            #             #       #         *    #     #      #
#    #     #    #     ####    ############ #       #        #     #     #      #
#    #     #    #                  #       #       #        #     #     #      #
#    #     #    #    #                     #       #        #     #     #      #
#          #    #    #                     #       #        #     #     #      #
#          #    #    #                     #       #        #     #     #      #
#          #    #    #########          ## #       #              #     #      #
#          #    #    #             #       #       ###############      #      #
#    #     #    #    #             #       #       #        #    #      #      #
#    #     #    #    #             #       #       #        #           #      #
#    #     #    #    #             #       #       #        #           #      #
#    #     #    #    #             #               #        #           #      #
#    #     #    #    ############    ############# #        #           #      #
#    #     #    #    #     #          #            #        #    #      #      #
##   #     #    #    #     #          #            #        #    #   ## #    ###
#    #     #    #    #     #                       #        #    #      #      #
#    #     #    #    #     #                       #        #    #      #      #
#    #     #    #    #     #                       #        #    #      #      #
#          #    #    #                             #             #      #      #
######    ##         #                             #             #      #      #
#                    #      ####################   #             #      #      #
#                    #             #               #         ####    ## #      #
#                    #    ##       #               ###      #           #      #
#   #           #    #     #       #               #        #           #      #
#   #      #    #    #     #                       #        #           #      #
#   #      #    #    #     #                       #        #      #    #      #
#   #      #    #    #     #                       #        #      #    #      #
################################################################################
