80 80
################################################################################
#       #    #                                                                 #
#       #    #                                                                 #
#       #    #                                                                 #
#       #    #                                                                 #
#       #    ##################    #############################################
#       #    #       #     #         #       #    #           #    #      #    #
#       #    #       #     #         #       #    #           #    #           #
#       #    #       #     #         #       #    #           #    #           #
#       #    #       #     #         #       #    #                #           #
#       #    #       #     #         #       #                     #           #
#       #    #             #    #    #       #                     #      #    #
#       #    #             #    #    #       #                     #      #    #
#       #    #             #    #    #       #                #    #      #    #
#       #    #             #    #    #       #   ############ #    #      #    #
#       #    #       #     #    #    #       #     #     #    #    #      #    #
#       #    #       #     #    #    #       #     #     #    #    #      #    #
#       #    #       #     #    #    #       #     #          #    #      #    #
#       #    #       #     #         #       #     #          #    #      #    #
#       #    #    ## #          #### #       #     #          #    #      #    #
#       #    #       #          #    #       ##    ####    ## #    #      #    #
#       #    #       #               #       #     #          #    #      #    #
#       #    #       #               #       #     #          #    #      #    #
#       #    #       #     #         #       #     #          #    #      #    #
#       #    #       #     #         #       #     #          #    #      #    #
#            #             #    #    #       #           #    #    #      #    #
#            #    ######## #    #    #       #      ##   #    #    #######    ##
#            #      #      #    #    ###     #           #    #    #      #    #
#            #      #      #    #    #       #           #    #    #      #    #
#       #    #      #      #    #    #       #     #     #    #    #      #    #
#       #    #             #    #    #       #     #     #    #    #      #    #
#       #    #             # *  #    #       #                     ##     #    #
#       #    #   ###       #    #    #       ###################          #    #
#       #    #             #    #    #            #        #              #    #
#####   #    #      #      #    #    #            #        #              #    #
#       #           #      #    #    #                     #              ###  #
#       #                            #                     #       #      #    #
#       #         ################## #       #     ##      ####    #      #    #
#       #             #              #       #                     #      #    #
#       #    #        #              #       #    #                #           #
#       #    #        #              #       #    #                #           #
######    ## #        #     #                #    #                #           #
#       #    #              #    ####        #    #                #           #
#       #    #              #                #    #                #      #    #
#       #    #              #                #    #    ########### #      #    #
#       #    #              #        #       #    #                #      #    #
#       #    #        #     #        #       #    #                #      #    #
#       #    #        #     #        #       #    #                #      #    #
#       #    #        #     #        #       #    #                #      #    #
#       #    #        #     #        #       #                                 #
#       #    #        #     #        #       #######    ########################
#       #    #        ##    #        #       #          #     #         #      #
#       #    #        #     #        #       #          #     #         #      #
#       #    #        #     #        #       #          #     #         #      #
#       #    ###      #     #        #       #    #     #     #         #      #
#       #    #        #     #        #       #    #     #     ###    ###      ##
#       #    #        #     #        #       #####    ## ##   #                #
#       #    #        #     #        #       #                #                #
#       #    #        #     #        #       #                #                #
#            #######    ### #        #       #                #                #
#            #              #        #       #                #######    #######
#            #              #        #       ###    ######### #    #       #   #
#            #              #        #       #    #           #    #       #   #
#       #    #        #     #        #       #    #           #            #   #
#       #    #        #     #        #       #    #           #            #   #
#       #    #        #     #        #       #    #           #            #   #
#       #    #        #     #        #       #    ######    ##             #   #
##      #    #                               #    #    #           #       #   #
#       #    #############################   #    #    #       #####    ###    #
#       #    #                        #      #    #    #           #           #
#       #    #                        #      #    #    #      #    #           #
#       #    #                               #    #    ###    #                #
#       #    #                               #    #    #      #            #   #
#       #    ##################    ###    ## #    #           #     ###    #   #
#       #    #         #                     #    #           #            #   #
#       #    #         #              #      #                #    #       #   #
#       #    #         #              #      #                #    #       #   #
#       #    #                        #      #         #      #    #       #   #
#       #    #                        #      #         #      #    #       #   #
################################################################################
