80 80
################################################################################
#    #                                                            #    #       #
#    #                                                            #    #       #
#    #                                                            #    #       #
#    #                                                            #    #       #
#    #                                                            #    #       #
#    ################################    ######################## #    #       #
#    #                     #                                      #    #       #
#    #                     #                                      #    #       #
#    #                     #                                      #    #       #
#    #                     #                                      #    #       #
#    #                     #    ################################# #    #       #
#     ###########    ##### #          #                           #    #       #
#                                     #                           #    #       #
#                                                                 #    #       #
#                                                                 #    #       #
#                                                                 #    #       #
######################################################    ####### #    #       #
#                                            #               #    #    #       #
#                                            #               #    #    #       #
#                                            #               #    #    #       #
#                                            #      #        #    #    #       #
######################    ################## #      #        #                 #
#             #      #    #    #    #        #      #        #                 #
#             #      #    #    #    #        #      ######                     #
#             #      #    #    #    #        #      #                      #####
#                    #    #    #             #      #             #    #       #
#      #                  #                  #      #             #    #       #
#      #                  #                  #      #        #    #    #       #
##     #   ###            #                  #      #        #    #    #       #
#      #      ####        #         #        #      #        #    #    #       #
#      #      #      #    #    #    #        #      #        #    #    #       #
#      #      #      #    #    #    #        #               #    #    #       #
#      #      #      #    #    #    #        ########    ### #    #    #       #
#             #      #    #    #    #        #               #    #    #       #
#########     #      #    #    #    #        #               #    #    #       #
#        #    #      #         #    #        #               #    #    #       #
#        #    #      #         #    ####     #                    #    #       #
#        #    #      #         #    #        ####    ############ #    #       #
#        #    #      #     *   #    #        #             #      #    #       #
#             #      #    #    #    #        #             #      #    #       #
#             #      #    #    #                           #      #    #       #
#             #      #    #    ##########                  #      #    #       #
###########    ##### #    #    #     #        ##      #    #      #    #       #
#       #       #    #    #    #     #                #    #      #    #       #
#       #       #    #    #    #     #       #        #    #      #    #       #
#       #       #    #    #    #     #       #        #    #      #    #       #
#       #       #    #    #    #     #       #        #    #      #    #       #
#       #       #    #    #    #     #       #######    ## #      #    #       #
#       #       #    #    #    #     #       #        #    #      #    #       #
#       #            #    #    #     #       #        #    #      #    #       #
#       #            #    #    #     #       #        #    #      #    #       #
#       #            #    #    #     #       #        #    #      #    #       #
#        ####        #    #    #     #       #        #    #      #    #       #
#               #    #    #    #     #       #        #    #      #    #       #
#               #    #    #    #     #       #        #    #      #    #       #
#               #    #    #    #     #       #        #    #      #    #       #
#       #       #    #    #    #     #       #        #    #      #    #       #
#       #       #    #    #    #     #       #        #    #      #    #       #
#       #       #    #         #             #        #    #      #    #       #
#       #       #    #   ##### #             #        #    #      #    #       #
#       #       #    #    #    #             #        #    #      #            #
#       #            #    #    #             ##    ## #    #      #    #########
#       ##    ###### #    #    #     #       #        #    #      #        #   #
#       #    #       #    #    #     #       #        #    #      #        #   #
#       #    #       #         #     #       #        #    #      #        #   #
#       #            #         #     #       #        #    #      #        #   #
#       #            #         #     #       #        #    #      #            #
#       #            #         #     #       #        #    #      #            #
#       #            #                       #        #           #            #
#       #    #       ##    ################# #                    #            #
#       #    #       #            #          #                    #        #   #
####    #    #       #            #          #                    #        #   #
#       #    #       #            #          #             #      #        #   #
#       #    #       #                       #        #    ###    #        #   #
#       #    #####   #                       #        #    #      ######   #   #
#       #    #       #                       #        #    #      #        #   #
#       #    #       #                       #        #    #      #        #   #
#       #    #       #            #          #        #    #      #        #   #
################################################################################
