80 80
################################################################################
#         #           #             #         #    #         #      #     #    #
#                     #             #         #    #         #      #     #    #
#                     #                       #    #         #      #     #    #
#                     #                       #    #         #      #     #    #
#                     #                       #    #    #    #      #     #    #
#                     ##############    ##### #    #    #    ##     #     #    #
#################    ##          #                 #    #    #      #     #    #
#                                #                 #    #    #      #     #    #
#                                #                 #    #    #      #     #    #
#                                                  #    #    #      #     #    #
#                                                  ###    ## #      #     #    #
#      ###########    #                            #    #    #            #    #
#      #              ###########    ############# #    #    #            #    #
#      #              #                            #    #    #            #    #
#      #              #                            #         ###    ##### #    #
#      #              #                            #         #    #       #    #
#                                                  #         #    #       #    #
##############################################     #         #    #       #    #
#                #        #    #     #             #    #    #    #       #    #
#                #        #    #     #             #    #    #    ##      #    #
#                #        #    #     #             #    #    #            #    #
#                #        #    #     #             #    #                 #    #
#                #        #    #     #             #    #                 #    #
#                         #    #     #   ######### #                      #    #
#                         #    #     #             ##################    ##    #
#                         #    #                   #    #          #           #
##################    ### #    #                   #    #          #           #
#     #      #       #    #                #       #    #          #           #
#     #      #       #                     #       #    #          #           #
#     #      #       #                             #     ####    ##    ## #    #
#     #      #       #          #############      #                      #    #
#     #      #       #         #    #              #                      #    #
#     #      #       #    #    #                   #                      #    #
#     #              #    #    #                   #    #                 #    #
#     #              #    #    #                   #    #####    ######## #    #
#     #              #    #                        #    #                 #    #
#     #              #    #######    ############# #    #                 #    #
#     #      #       #    #          #     #       #    #                 #    #
#     #      #       #    #          #     #       #    #            #    #   ##
#     #      #       #    #          #             #    #            #    #    #
#     #      #       #    #    #     #             #    #            #    #    #
#     #      #       #    #    #                   #    #            #    #    #
#     #      #       #    #    #                   #                           #
#     #      #       #    #    #           ##      #######    ##################
#     #      #       #    #    #######     #       #     #         #           #
#     #      #       #    #    #           #       #     #         #           #
#     #      #       #    #    #           #       #               #           #
#     ####   #       #    #    #           #       #               #     #     #
#     #      #       #    #                #       #               #     #     #
#            #       #    #############    #       #               #           #
#            #       #    #      #    #    #       #               #########   #
#            #       #    #      #    #    #       #               #     #     #
#   ##       #            #      #         #       ##    ######### #     #     #
#     #      #            #      #         #       #     #    #          #     #
#     #      #            ####   #         #       #     #    #          #     #
#     #      ####         #      #         #       #     #    #          #     #
#     #      #       #    #      #    #    #       #     #    #          ###   #
#     #      #       #    #      #    #    #       #     #    #    #     #     #
#     #      #       #    #      #    #    #       #     #    #    #     #     #
#     #      #       #    #      #    #    #       #          #    #     #     #
#     #      #       #    #      #    #    #       #          #    #     #     #
#     #      #       #    #      #    #*   #                  #    #     #     #
#     #      #       #    #      #    #    #        ##    ### #    #     #     #
#     #      #       #    #      #    #    #             #    #    #     #     #
#     #      #       #    #      #    #    #             #    #    #     #     #
#     #      #       #    #      #    #    #       #          #    ###   #     #
#     #      #       #    #           #    #       #          #    #     #     #
####    #### #       #    #           #    #       #          #    #     #     #
#            #       #    #           #    #       #          #    #     #     #
#            #       #    #                #       #     #    #    #     #     #
#            #       #    #      #   ##### #       ###   #    #    #     #     #
#     #      ########     #      #    #    #       #     #    #    #           #
#     #      #      #     #      #    #    #       #     #    #    #           #
#     #      #            #      #    #    #       #     #         #           #
#     #   ## #            #      #         #       #     #         #           #
#     #      #            #      #         #       #     #         #     #     #
#     #      #            #      #         #       #     #         #     #     #
#     #      #      #     #      #         #       #     #    #    #     #     #
################################################################################
