80 80
################################################################################
#    #        #      #       #    #       #                                    #
#    #        #      #       #    #       #                                    #
#    #        #      #       #    #               #                            #
#    #        #      #       #    #               #                            #
#    #        #      #       #    #               ############    ##############
#    #        #      #       #    #               #          #                 #
#    #        #      #       #    #       #       #          #                 #
#    #        #      #       #    #       #       #                            #
#    #        #      #       #    #       ####    #                            #
#             #      #    ## #    #       #       #                            #
#             #      #       #    #    ## #       #   ####### #####    #########
#             #      #       #    #       #       #          #                 #
#             #      #       #    #       #       #          #                 #
#    #        #      #       #    #       #       #          #                 #
#    #        #   ## #       #    #       #                                    #
#    #        #      #       #    #       ############    ######################
#    #        #      #       #    #       #                #      #    #       #
#    #        #      #            #       #                #      #    #       #
#    #        #      #            #       #                #      #    #       #
#    #        #      #            #       #     #     #    #      #    #       #
#    #        #      #            #       #     #     #    #      #    #       #
#    #        #      #       #    #       #     ####    ###       #    ##    ###
#    #        #      #       #    #       #     #                 #    #       #
#    #        #      #       #    #       #     #                 #    #       #
#    #        #      #       #    #       #     #           ###   #    #       #
#    #        #      #       #    #       #     #          #           #       #
#    #        #      #       #    #       #     #     #    #                   #
#    #        #      #       #    #       #     #     #    #                   #
#    #        #      #       #    #       #     #                              #
#    #        #      #       #    #       #     #######    ###### #            #
#    #        #      #       #    #       #     #                 #    #       #
#    #        #      #       #    #       #     #                 #    #       #
#    #        #      #       #    #       #     #                 #    #       #
#    #        #      #       #    #       #     #         #       #    #       #
#    #        #      #       #    #       #     #    #    #       #    #       #
#    #        #      ######    ## #       #     #    #    #       #    #       #
#    #        #      #       #    #       #     #    #    #       #    #       #
#    #        #      #       #    #       #     #         #       #    #       #
#    #        #      #       #    #       #     #    #### #       #    #       #
#    #####    #      #       #    #       #     #    #    #       #    #       #
#    #        #      #       #            #     #    #    #       #    #       #
#    #        #      #       #            #     #    #    #       #    #       #
#    #        #      #       #            #     #    #    #       #    #       #
#    #        #      #       #            #     #    #    #       #    #       #
#    #               #       #    #       #     #    #    #       #    #       #
#    #               #   ### #    #       #     #    #    #       #            #
#    #               #            #       #     #    #    #       #   ##########
#    #               #            #       #     #    #    #       #    #       #
#    #        #      #            #       #     #         ##      #    #       #
#    #        #      #                    #     #         #       #    #       #
#    #               ######    ########## #     #         #       #            #
#    ##    ######### #            #       #     #         #       #            #
#    #     #    #                 #       #     #    #    #       #            #
#    #     #    #                 #       #     #    #    #       #            #
#    #     #              #       #       #     #    #                         #
#    #                    #       #       #     ##    ##########################
#    #               #    #       ##      ##    #                    #         #
#    #      ####     ##    ###### #       #     #                              #
#    #               #            #       #     #                              #
#    #     #         #            #       #     #                              #
#    #     #         #                    #     #                              #
#          #         #                    #     #                              #
###########    ##### #                                                         #
#              #     ########    ###############################################
#                    #              #                                 #        #
#                    #                                                #        #
#                    #                                                #        #
######    ##### ##   #                                                #    #   #
#        #     #     #                                                #    #   #
#        #     #     #              #                                 #    #   #
#        #     #     #              #                                      #   #
#        #     #     #                                                     #   #
#   #### #     #     ############################    #################     #   #
#   #    #     #     #                                                     #   #
#   #    #     #     #                                                #####    #
#        #     #     #                                                #        #
#              #     #                                        #       #        #
#              #     #                                *       #       #        #
################################################################################
