80 80
################################################################################
#       #                                    #                   #         #   #
#       #                                                        #         #   #
#       #                                                                  #   #
#       #                                                                  #   #
#       #                                                                  #   #
#       ######################    ########## #                             #   #
#       #                               #    #                             #   #
#       #                                    #####    #################### #   #
#       #                                    #                             #   #
#       #                                    #                             #   #
#       #                                    #                             #   #
#       #                                                                  #   #
#       ###    ########################################################### #   #
#       #      #                 #     #                                   #   #
#       #      #                 #     #                                   #   #
#       #      #                 #                                         #   #
#       #      #                 #                                         #   #
#       #      #                        ######    ### ##########      #    #   #
#       #      #                            #         #               #    #   #
#       #      #                       #    #         #               #    #   #
#       #      #########    ########## #    #         #               #    #   #
#       #      #                       #    #         #               #    #   #
#       #      #                       #              ##############    ## #   #
#       #      #                       #              #        #               #
#       #      #                                      #        #               #
#       #      ##    ################################ #        #               #
#       #      #                          #           #        #               #
#       #      #                          #           ######   #           #   #
#       #      #                                      #        ##    ##### #   #
#       #      #                                      #                    #   #
#       #      #                                      #                    #   #
#       #      #                                      #                    #   #
#       #      #                                                           #   #
#              ########################    ############################### #   #
#              #                                                           #   #
#              #                                                           #   #
#                                                                          #   #
#       #                                                                  #   #
#       #                                                    #             #   #
#       #                                                    #             #   #
#       #                                                                      #
#       ###########################################################    #########
#       #     #      #                  #         #                            #
#       #     #      #                  #         #                            #
#       #     #      #                  #         #                            #
#       #     #      #                  #         #                            #
#       #     #      #    #   ######### #                                      #
#       #     #           #             #                                      #
#       #     #           #             #                                      #
#       #     #           #             #                                      #
#       #     #                         ############################    ########
#       #     #      ############    ## #       #                              #
#       #     #      #     #    #       #       #                              #
#####   #     #      #     #            #       #                              #
#       #     #      #     #            #       #                              #
#       #     #      #     #            #       ###################    #########
#       #     #      #     #            #                  #     #       #     #
#       ###          #     #    ###    ##                  #             #   * #
#       #            #          #                          #             #     #
#       #            #          #                    #                   #     #
#       #            #          #               #    #                   #     #
#       #            #          #               ###    ####    ######### #     #
#       #            #     #            #       #                #       #     #
#       ########     #     #    ####### #       #          #             #     #
#       #            #     #            #       #          #             #     #
#       #            #     #            #       #          #                   #
#       #            #     #            #       #                              #
#       #            #     #            #       ######################         #
#       #                  #            #       #         #                    #
#       ###################    ######## #       #         #              #     #
#       #           #                   #       #         #              #     #
#       #           #                   #       #         #              #     #
#       #                               #       #####      #######    ## #     #
#       #                               ####    #    #            #      #     #
#       #####    ### ############    ## #       #    #            #      ####  #
#       #                               #       #                        #     #
#       #           #                   #       #         #              #     #
#       #           #                   #       #         #              #     #
################################################################################
