80 80
################################################################################
#                                                                         #    #
#                                                                         #    #
#                                                                         #    #
#                                             #                           #    #
########################    ################# ####################    ### #    #
#       #      #     #                 #      #            #     #        #    #
#       #      #                       #      #            #              #    #
#       #      #                       #      #            #              #    #
#       #      #                       #      #            #              #    #
#       #      #      ###########      #      ##    ###### #   ##      ## #    #
#              #     #      #    #     #      #    #       #     #             #
#              #     #      #    #     #      #    #       #     #             #
#              #     #           #     #   ## #    #       #     #             #
######    #### #     #           #     #      #            #                   #
#     #        #     #           #     #      #            #######    ### #    #
#     #        #     #####    ## ###   #      #     ####   #         #    #    #
#     #        #     #    #      #     #      #            #         #    #    #
#              #     #    #      #     #      #    #                      #    #
#              #     #    #      #            #    #                      #    #
#              #     #                        #                                #
#              #     #                        ###########    ###################
#  ## #        #     #                        #     #    #        #            #
#     #        ##    ########    ############ #     #    #        #            #
#     #        #     #    #                   #     #    #        #            #
#     #        #     #    #                   #     #    #                     #
#     #        #     #    #                   #     #    #                     #
#     #        #     #    #                   #     #    #                     #
#     #        #     #    ##    ##    *       #     #    #                     #
#     #        #     #    #      #            #     #    #   ###################
#     #        #     #    #      #########    #     #    #     #      #    #   #
#     #        #     #    #      #            #     #    #            #    #   #
#     #        #     #    #      #            #     #    #            #    #   #
#     #        #     #    #      #            #     #    #            #    #   #
#     #        #     #    #                   #     #    #            #    #   #
#     #        #     #     ##########    #### #     #    #     #      #    #   #
#     #        #     #              #    #    #     #    #     #      #    #   #
#     #        #     #              #    #    #     #    #            #    #   #
#     #        #     #              #    #    #     #    #   ######## #    #   #
#     #        #     #    #         #    #    #     #    #    #       #    #   #
#     #        #     #    #              #    #     #    #    #       #    #   #
#     #        #     #    #              #    #     #         #       #    #   #
#     #        #     #    #              #    #     #         #       #    #   #
#     #        #     #    #              #    #     #         #       #    #   #
#     #        #     #    ###    ####### #    #     #         #       #    #   #
#     #        #     #    #       #      #    #          #    #   ### #    #   #
#     #        #     #    #       #      #    #          #    #       #    #   #
#     #        #     #    #       #      #    #          #    #       #    #   #
#     #        #     #    #       #      #    #          #    #       #    #   #
#     #        #     #    #       #      #    #     #    #    #       #    #   #
#     #        #     #    #       #      #    #     #    #    #       #    #   #
#     #        #     #    #       #      #    #     #    #    #       #    #   #
#     #        #     #    #       #           #     #    #    #       #    #   #
#     #        #     #    #       #           #     #    #    #       #    #   #
#     #              #    #       #           #     #    #    #       #    #   #
#     #              #    #       #           #     #    #    #       #    #   #
#     #              #    #       #      #    #     #    #    #       #    #   #
#     #              #    #       #      #    ##    #    #    #       #    #   #
#     #   #### #     #    #       #      #    #     #    #    #       #        #
#     #        #     #    #       #      #    #     #    #    #       #        #
#     #        #     #    #       #      #    #     #    #    #       #        #
#     #        #     #    #       ###    #    #     #    #    #       #        #
#                    #    #       #      #    #          #    #       #    #   #
########    ######## #    #    ## #      #    #######    #    #       #    #   #
#    #          #    #    #       #      #    #    #     #    #       #    #   #
#    #          #    #    #       #      #    #    #     #    #       #    #   #
#    #          #    #    #       #      #    #    #     #    #       #    #   #
#    #          #    #    #       #      #    #    #     #            #    #   #
#    #          #    #    #       #      #    #    #     #            #    #   #
#    ########   #    #    #       #      #    #    #     #                  ####
#    #    #          #    #       #      #    #    #     #                     #
#    #    #          #    #       #      #    #    #     #    #                #
#                    #    #              #    #          #    #                #
#                    #    #              #    #          #    #       #        #
#               #    #    #              #    #          #    #       #        #
#  ############ #    #    #              #    #          #    #       #    #   #
#               #    #    #       #      #    #    #     #    #       #    #   #
#               #    #    #       #      #    #    #     #    #       #    #   #
#               #    #    #       #      #    #    #     #    #       #    #   #
################################################################################
