80 80
################################################################################
#    #    #        #      #                  #           #                #    #
#    #    #               #                              #                #    #
#    #    #               #                                          #    #    #
#         #   #####    ## #                                   #      #    #    #
#         #               ###    ########################     ####   #    #    #
#         #        #      #            #         #            #      #    #    #
#         #        #      #            #         #       #    #      #    #    #
#    #    #        #      #                      #       #    #      #    #    #
#    #    #        #      #                      #       #    #      #    #    #
#    #    #               #                      #       #    #      #    #    #
#    #     ##    ######## #####    ##############    ### #           #    #    #
#    #         #          #                              ######      #    #    #
#    #         #          #                              #           #    #    #
#    #         #          #                              #           #    #    #
#    #    #    #          #                              #           #    #    #
#    #    #     ####      #                                          #    #    #
#    #    #               ###    ################################### #    #    #
#    #    #               #                 #        #    #     #    #    #    #
#    #    #               #                 #        #    #     #    #    #    #
##   #                    #                 #        #    #     #    #    #    #
#    #######    ######### #                          #    #     #    #    #    #
#    #              #     #                          #    #     #    #    #    #
#    #              #     #                          #    #     #    #    #    #
#    #              #     #                          #    #     #    #    #    #
#    #                    ########################   #    #     #    #    #    #
#    #                    #     #                    #    #     #    #    #    #
#    #                          #                    #    ###        #    #    #
#    #                          #                    #    #          #    #    #
#    #              #           #                    #    #          #    #    #
#                   #           #########    ####### #    #          #         #
#################    #### #     #     #      #       #          #    #         #
#      #     #       #    #     #     #      #       #          #    #         #
#      #     #       #    #     #     #      #       #          #    #         #
#      #     #       #    #     #     #      #       #          #    #    #    #
#      #     #       #    #     #     ####   #       #    #     #    #    #    #
###    #     ####    #    #     ###          #       #    #     #    #    #    #
#      #     #       #    #     #            #       #    #     #    #    #    #
#      #     #       #    #     #            #       #    #     #    #    #    #
#      #     #       #    #     #            #       #    #     #    #    #    #
#      #             #    #     #            #       #    ######     #    #    #
#      #             #    #     #   ######## #       #    #    #     #    #    #
#      #             #    #     #     #      #       #    #    #     #    #    #
#      #                  #     #     #      #       #    #    #     #    #    #
#      ###   #            #     #     #      #       #    #    #     #    ###  #
#      #     #            #           #      ##      #    #    #     #    #    #
#      #     #            #           #      #       #    #    #     #    #    #
#      #     #       #    #           #      #       #    #    #     #    #    #
#      #     #       #    #           #   ## #       #    #    ###   # *  #    #
#      #     #       #    #     #     #      #       #    #          #    #    #
#            #       #    #     #     #      #       #    #          #    #    #
#            #       #    #     ##    #      #       #    #          #    #    #
#            #       #    #     #            #       #    #          #    #    #
#            #       #    #     #            #       #               #    #    #
#      #     #       #    #     #            #       ########    ### #    #    #
#      #     #       #    #     #                                    #    #    #
#      #     #       #    #     #     #                              #    #    #
#      #     #       #    #     #     #                              #         #
#######      #       #    #     #     #                      #       ######    #
#   #        #       #    #     #     #      #       ####    ####    #    #    #
#   #        #       #    #     #     #      #       #       #       #         #
#   #        #       #    #     #     #      #       #       #       #         #
#   #        #       #    #     #     #      #       #       #       #         #
#   #        #       #    #                                                    #
#   #        #       #    ##################################################   #
#   #        #       #    #        #                                           #
#   ###      #       #    #        #                                           #
#            #       #    #        #                                           #
#            #       #    #        #                                           #
#            #       #    #        #                                      #    #
#            #       #    ####     #                                      #    #
#   #        #       #    #        #                                      #    #
#   #        #       #    #        #                                           #
#   #        #            #        #######    ##################################
#   #        ##########   #              #                                     #
#   #        #     #      #              #                                     #
#   #        #            #              #                                     #
#   #        #            #                                                    #
#   #        #            #        #                                           #
################################################################################
