80 80
################################################################################
#   #              #                       #     #        #        #           #
#   #              #                       #     #        #        #           #
#   #              #                       #     #        #        #           #
#                  #                       #     #        #        #   #########
#                  #      #                #     #        #        #    #      #
#                  ###    ################ #     #                 #    #      #
##############     #                #      #     #                 #    #      #
#   #              #                #      #     #                 #    #      #
#   #              #                #      #     #                 #    #      #
#   #                               #      #     #        #        #    #      #
#   #                   ########### ####   #     #        #        #    #      #
#   ####    #######            #           #     #        #        #    #      #
#                                          #     #        #        #    #      #
#                  #                       #     #        #        #    #      #
#                  #                       #     #        #        #    #      #
#                                          #     #        #        #    #   ####
############################    ########## #     #        #        #    #      #
#                                #         #     #        #        #           #
#                                #         #     #        #        #           #
#                                #               #        #                    #
#         #                                      #        #                    #
#         #             #                        #        #             #      #
#                       #                        #        #             #      #
###################     #                  #     #        #        #    #      #
#    #                  #                  #     #        #        #    #      #
#                       #                  #     #        #        #    #      #
#                       ##############     #     #        #        #    #      #
#                       #                  #     #        #        #    #      #
#     ###############   #                  #     #        #        #    #      #
#    #       #          #                  #     #        #        #    #      #
#    #       #          #       #     *    #     #        #        #    #      #
#    #                  ###     #######    #     #        #        #    #      #
#    #                  #       #          #     #        #        #    #      #
#    #                  #       #          #     #        #        #    #      #
#    #                  #       #          #     #        #        #    #      #
#                                                #        #        #    #      #
###################################    ######### #        #        #    #      #
#                 #       #                      #        #        #    #      #
#                         #                      #        #        #    #      #
#                         #                      #        #        #    #      #
#                         #                      #        #        #    #      #
#    ##                    ######    ##   ###### #        #        #    #      #
#     #           #                   #          #        #        #    #      #
#     #           #                   #          #        #        #    #      #
#     #                               #          #        #        #    #      #
#     ##############      #           #          #        #        #    #      #
#     #                   #                      #        #        #    #      #
#     #                   ########    ########## #        #        #    #      #
#     #                   #    #         #       #        #        #    #      #
#     #                   #    #         #       #        #####    #    #      #
#                         #    #                 #        #        #    #      #
##################    ### #                      #        #        #    #      #
#       #      #     #    #                      #        #        #    #      #
#       #      #     #    #                      #        #        #    #      #
#       #      #     #    #              #       #        #        #    #      #
#       #            #    #    #         #       ####     #        #    #      #
#                    #    #    #         #       #        #        #    #      #
#                    #    #    #         #       #        #        #    #      #
#                         #    #         #       #        #        #    #      #
#              #          #    #         #       #        #        #    #      #
#       ##     #          #    #         #       #        #        #    #      #
#   ### #      #          #    #         #       #        #                    #
#       #      #######    #    #         ####    #        #   ##################
#       #      #    #     #    ####      #       #        #        #           #
#       #      #    #     #    #         #       #        #        #           #
#       #      #    #     #    #         #       #        #                    #
#####    ##### #    #     #    #         #       #        #                    #
#    #    #    #    #     #    #         #       #        ######    #########  #
#    #    #    #    #     #    #         #       #        #                    #
#         #    #    #     #    #         #       #        #        #           #
#         #    #    #     #    #         #       #        #        #           #
#         #    #    #     #    #         #       #                             #
#              #    #     #    #         #        ####################    ######
#              #    #     #              #             #                       #
##    ####     #    #     #######    ### #             #                       #
#              #    #     #              #                                     #
#         #    #          #              #       #                             #
#         #    #          #              #       #                             #
################################################################################
