80 80
################################################################################
#                          #      #              #           #         #       #
#                          #      #                          #         #       #
#                          #      #                                    #       #
#                          #      #                                    #       #
################    ###### #   ## #    ### #                           #       #
#     #       #       #    #      #        #     ######    ########### #       #
#     #       #            #      #        #     #     #        #      #       #
#     #                    #      #        #     #     #        #      #       #
#     #                    #               #     #     #        #      #       #
#     #                    #               #     #     #               #       #
#     #               #    #               #     #     #               #       #
#     #       #       #    #   ########### #     #     #               #       #
#     #       #       #    #    #    #     #     #     #               #       #
#     #    ## ####    #         #    #     #     ###   ####    ####### #       #
#     #       #       #         #    #     #     #                     #       #
#     #       #       #         #    #     #     #                     #       #
#     #       #       #         #          #     #                     #       #
#     #               #    #    #          #                           #####   #
#     #   ########### #    #    #          ###############    ######## #       #
#     #    #     #    #    #     #######   #                           #       #
#     #    #     #    #    #               #                           #       #
#     #    #     #    #    #               #                           #       #
#     #    #     #    #    #               #                           #       #
#     #    #     #    #    #    #    #     ############      #######   #       #
#     #    #          #    #    #    ###   #          #     #          #       #
#     #               #    #    #    #     # *              #          #       #
#     #               #    #    #    #     #                #          #       #
#     #               #    #    #    #     #                #          #       #
#     #          #    #    #    #    #     #                #          #       #
#     #    #     #    #    #                                           #       #
#     #    #     #    #    ###################    #####################        #
#     ###    ### #    #    #                                                   #
#     #          #    #    #                                                   #
#     #          #    #    #                                                   #
#     #          #    #    #                                                   #
#     #    #     #    #    #                                                   #
#     #    #     #    #    #############################    ####################
#     #    #     #    #    #      #                #     #     #      #        #
#     #                    #      #                #     #     #      #        #
#     ############    #### #      #                #     #     #      #        #
#     #                    #      #     #          #     #     #      #        #
#     #                    #            #          #     #     #      #        #
#     #                    #            #          #     #     #               #
#     #    #               #   ###                 #     #     #               #
#     #    #               #       ######    ##### #     #     #               #
#     #    #   ########### #      #                #     #     #############   #
#     #    #         #     #      #                #     #                     #
#     #    #         #     #      #                #     #                     #
#     #    #         #     #      #                #     #                     #
#     #    #    #    #     ####    ############### #     #                 #   #
#     #    #    #    #     #      #     #     #    #     #     #   ####### #   #
#     #    #    #    #     #      #     #     #    #     #     #           #   #
#     #    #    #    #     #      #     #     #    #     #     #           #   #
#     #    #####     ###   #      #     #     #    #     #     #           #   #
#     #    #    #    #     #      ##    ###   #    #     #                 #   #
#     #    #    #    #     #      #           #    #     ##################    #
#     #    #    #    #     #                  #          #    #           #    #
#     #    #    #          #                  #          #    #           #    #
#     #    #    #          #                             #    #                #
#     #    #    #          #            #                #    #     #          #
#     #    #    #          #      #     #          #                #          #
#     #    #    #    #     #      #     #######    #                #          #
#     #    #    #    #     #      #     #     #    #                ########   #
#     #    #    #    #     #      #     #     #    #                #     #    #
#     #    #    #    #     #      #     #     #    #     ###    ### #     #    #
#     #    #    #    #     #      #     #          #     #    #     #     #    #
#     #    #    #    #     #      #     #          #     #    #     #     #    #
#     #    #    #    #     #      #     #          #     #          #     #    #
#     #    #         #     #      ######    ###### #     #          #          #
#          #         #     ####   #          #     #     #          #          #
#          #         #     #      #          #     #                           #
#          #         #     #      #          #     ############    #############
#          #    #    #     #      #          #     #                   #       #
#     #    #    #    #     #      #          ##    #                   #       #
#  ## #    #    #    #     #      ########   #     #                           #
#     #    #    #    #     #      #                #                           #
#     #    #    #    #     #      #                #                           #
#     #    #    #    #     #      #                #                           #
################################################################################
