80 80
################################################################################
#      #      #     #        #    #        #       #                #          #
#      #      #     #        #    #                #                #          #
#      #      #     #             #                #                #          #
#      #      #     #             #                 ##    ######### #      #   #
#      #      #     #             #                            #    #      #   #
###    #      #     #             #        #                        #      #   #
#      #      #     #             #        #                        #      #   #
#      #      #     #             #        ####    #                 ###   #   #
#      #      #     ##########    #        #       ######    ##            #   #
#      #      #     #      #      #        #       #           #           #   #
#      #      #     #      #      #        #       #           #           #   #
#      ##     #     #      #      #        #       #           #    #      #   #
#      #      #     #      #      #        #                   #    #      #   #
#      #      #            #      #        ##################    ## #      #   #
#      #      #      ##    #      #        #    #         #    #    #      #   #
#      #      #            ###    #        #    #         #    #    #      #   #
#      #      #            #      #        #                   #    #      #   #
#      #      #     #      #      #        #                        #      #   #
#      #      ###   #      #      #        #                        #######    #
#      #      #     #      #      #        #                        #      #   #
#      #      #     #      #      #        ###########    #         #      #   #
#      #      #     #      #      #        #     #        #         #      #   #
#             #     #             #        #     #        #####     #      #   #
#             #     #             #        #     #        #    #    ##     #   #
#             #     #             #        #     #        #    #    #      #   #
#             #     #             #   #### #              #         #          #
#      #      #     #      #      #        #              #         #          #
#      #      #     #      #      #        #                                   #
#      #      #     #      #      #        ###    ##############################
#      #      #     #      #      #        #             #                     #
#######    ## #                   #        #             #                     #
#   #    #    #######    ######## #        #             #                     #
#   #    #    #    #      #       #        #             #                     #
#   #    #    #    #      #       #        #             #                     #
#   #    #    #    #      #       #        #    #########    ###################
#   #    #    #    #      #       #        #     #                             #
#   #    #    #    #      #       #        #     #                             #
#   #    #    #    #      #       #        #                                   #
#   #    #    #    #      ####    #        #                                   #
#   #    #    #    #      #       #                                            #
#   #    #    #    #              #########################################    #
#   #    #    #    #              #      #                #    #               #
#   #    #         #                     #                #    #               #
#   #    #         #                     #                                     #
#   #    #         #      #                                                    #
#   #    #         #      #                                                    #
#   #    #    #    #      #       #                             ##    ##########
#   #    #    #    #      #       ############    ####### #    #               #
#   #    #    #    #      #       #                #      #    #               #
#   #    #    #    #      #       #                #      #    #               #
#   #    #    #    ####    ###### #                #      #                    #
#   #    #    #    #      #       #                #      #########    #########
#   #    #    #    #      #       #####    ####### ###    #                #   #
#   #    #    #    #      #       #                #      #                    #
#   #    #    #    #              #                #      #                    #
#   #    #    #    #              #                #      #                    #
#   #    #    #                   #           #           #                    #
#   #    #    #                   #           #           #                    #
#   #         #                   #                                    *       #
#   #         ##################    ############################################
#   #         #                                    #             #       #     #
#   #         #                                    #                     #     #
#   #         #                                    #                     #     #
#   #####     #                                    #                     #     #
#   #    #    ##############    ################## ####    ###### ####   ##    #
#   #    #    #                                                  #       #     #
#   #         #                                                  #       #     #
#   #         #                                                  #       #     #
#   #         #                                                  #             #
#   #         #####    ######################################### #             #
#   #    #    #                                        #         #             #
#   #    #    #                                        #         #             #
#   #    #    #                                        #         ############  #
#   #    #    #                                        #         #             #
#   #    #    ###############    ##################### ##    ### #             #
#   #    #    #                                                  #             #
#        #    #                                                  #             #
#        #    #                                                  #         #   #
################################################################################
