80 80
################################################################################
#   #    #           #      #                  #    #       #     #     #      #
#   #    #           #                         #    #       #     #     #      #
#   #    #           #                         #            #           #      #
#   #    #    #      ####                      #            #           #      #
#   #    #    #      #       #############     #            #           #      #
#   #    #    ####   #      #                  #            #    ###### #      #
#   #    #    #      #      #                       #    ## #    #      #      #
#   #    #    #      #      #                       #       #    #      #      #
#   #    #    #      #      #                       #       #    #      #      #
#   #    #    #      #      #                       #       #    #      #      #
#   #    #    #      #                         #    #       #    #      #      #
#   #    #####    ## ###    ################## #    #       #    #      #      #
#   #    #    #      #      #             #    #    #       #    #      #      #
#   #    #    #      #      #                  #            #    #      #      #
#   #    #    #      #      #                  ##########   #    ###    ####   #
#   #    #           #      #                  #            #    #      #      #
#   #    #           ###    #                  #            #    #      #      #
#   #    #           #      #                  #            #    #      #      #
#   #    #           #      ###########    ### #      #     #    #      #      #
#   #    #    #      #      #      #           #      #     #    #      #      #
#   #    #    #             #      #           #      #     #    #      #      #
#   #         #             #      #           #      #     #    #      #      #
#   #         ####          #      #           #      #     #    #      #      #
#   #         #             ####   #           #      #     #    #      #      #
#   #         #      #      #          ####### #      #     #    #      #      #
#   #    #    #      #                         #      #     #           #      #
#   #    #    #      #                         #      #     #           #      #
#   #    #    #      #                         #      #     #           #      #
#   #    #                                     #      #     #           #      #
#   #    ##############    ################### #      ###   #    #      #      #
#   #    #                                     #      #     #    #      #      #
#   #    #                                     #      #     #    #      #      #
#   #    #                                     #      #     #    #      #      #
#   #    #                #                    #      #     #    #      #      #
#   #    #                #                    #      #     #    #      #      #
#   #    #                #                    #      #     #    #             #
#        #                                                  #    #             #
#        ################################    ############## #    #             #
#        #                     #      #     #               #    #             #
#        #                     #            #               #    #             #
#   #    #                     #            #               #                  #
#   #    #                     #            #               #######    #########
#   #    #                     #            #               #        #    #    #
#        ####    ############# ###    ##### ##    ######### #        #    #    #
#  ##### #       #    #        #            #               #        #    #    #
#   #    #       #    #        #                                     #    #    #
#        #            #        #                                     #    #    #
#        #            #        #                                     #        *#
#        #            ######   #####################    ####         #         #
#        ####    #### #                                     #        #         #
#   #    #                                                  #        #         #
#   #    #                                                  #        #    #    #
#   #    #                                                  #        #    #    #
#   #    #                                                  #        #    #    #
#                                                           ######   #    #    #
################################################    ####### #        #    #    #
#   #                               #                       #        #    #    #
#   #                               #                       #        #    #    #
#                                   #                       #        #    #    #
#                       #           #                       #        #    #    #
#                       #                                   #        #    #    #
#                       #                                   #        #    #    #
##    ################# #                                   #        #    #    #
#   #          #        #                                   #        #    #    #
#   #          #        ###############    ################ #        #    #    #
#              #        #                            #      #        #    #    #
#              #        #                            #      #        #    #    #
#              ####     #                            #      #        #    #    #
#              #        #                            #      #        #    #    #
#              #        #                            #      #        #         #
##    ######## #        #                            #      #        #######   #
#      #       #        ######################    ## #   ## #        #         #
#      #                #                 #          #      #        #         #
#                       #                 #                 #                  #
#                       #                 #                 #                  #
#                       #                                   #             #    #
#              #        #                                   #             #    #
#      #       #        #                            #      #        #    #    #
################################################################################
