80 80
################################################################################
#      #                                   #          #      #      #    #     #
#                                          #          #      #      #    #     #
#                                          #          #      #      #    #     #
####    ########################    ###### #    ##### #      #      #    #     #
#                                          #     #    #      #      #     ##   #
#      #                                   #     #    #      #      #          #
#      #                                   #          #      #      #          #
#      #                                   #          #      #      #          #
#######    ############################### #                 #      #    #     #
#      #                                   #                 #      #    #     #
#      #                                   #    ##           #      #    #     #
#      #                                   #     #           #      #    #     #
#                                                #    #      #      #    #     #
#                                                #    #      #      #    #     #
#                                                     #      #      #          #
###################    ############################## #      #      #    #######
#      #          #     #       #     #         #     #      #      #     #    #
#      #          #     #       #     #         #     ####   #      #     #    #
#      #          #     #       #     #         #     #      #      #     #    #
#      #     #    #     #       #     #    #    #     #      #      #     #    #
#            #    ##    #       #     #    #    #     #      #      #     #    #
#            #    #     ##      #     #    #    #     #      #      #     #    #
#       ###    ## #     #       #     #    #    #     #      #      #          #
#                 #     #             #    #    #     #      #      #          #
#      #                #             #    #    #     #      #      #          #
#      #                #             #    #    ##    #      #      ##         #
#      #                #             #    #    #     #      #      #     #    #
#      #                #       #     #    #    #     #      #            #    #
#      ####    ######## #       #     #    #    #     #      #            #    #
#      #          #     #       #     #    #          #      #            #    #
#      #          #     #             #    #          #      #            #    #
#      #          #     ###########   #    #          #      #            #    #
#      #          #     #      #      #    #          #      #                 #
###    #######          #      #      #    #    #     #      #    ##############
#      #                #      #      #    #    #     #      #       #     #   #
#      #                #      #      #    #    #     #      #       #     #   #
#      #                       #      #    #    #     #      #       #     #   #
#      #     #    #            #      #    #    #     #      #       #         #
#      #     #    #            #      #    #    #     #      #       #         #
#                              #      #    #    #     #      #       #         #
#    ################## #      #      #    #          #      #       #         #
#                 #     #      #   ## #    #   ###### #      #       #     #   #
#                 #     #      #      #    #    #     #      #       #     #   #
#                 #     #      #      #    #    #     #      #       #     #   #
#                 #     ##            #    #    #     #      #       #     #   #
######    ########      #             #    #    #     #      #       #     #   #
#                       #             #    #    #     #      #       #     #   #
#                       #             #    #    #     #      #       #     #   #
#                       #             #    #    ##    #      #             #   #
#                                     #    #    #     #      #             #   #
#########################    ######## #    #    #     #      #             #   #
#         #                           #    #          #      #             #   #
#         #                                #          #      #       #     #   #
#         #                                #          #      #       #     #   #
#   #     #                                #          #      #       #         #
#   #     #                                #    #     #      #       #    ######
#   #     #################    ###### #    #    #     #      #       #    #    #
#   #     #     #       #             #    #    #     #      #       #    #    #
#   ###   #     #                     #    #    #     #      #       #    #    #
#   #     #     #                     #         #     #      #       #    #    #
#   #     #     #                     #######    #### #      #####   #      *  #
#   #     #     #                     #     #    #    #      #       #         #
#   #     #     #                     #     #    #    #              #         #
####      #     #                     #          #    #              #         #
#   #           ###########    ###### #          #    #              #    #    #
#   #           #    #      #         #          #    #              #    #    #
#   #           #           #         #          #    #              #    #    #
#   #           #           #         ###   #    #    #              #         #
#   #     #     #                     #     #         #############    #########
#   #     #     #                     #     #         #    #          #        #
#         #     #    #                #     #         #    #          #        #
#         #     #    #                #     #         #    #                   #
#         #     #    #                #     #         #                        #
#         #     #    #########    ### #     ###    ## #                        #
#   #     #     #    #                #     #         #     ########    ########
#   #     #     #    #                #     #         #                        #
#   #     #          #                #     #         #    #                   #
#   #     #          #     #          #     #         #    #                   #
################################################################################
