80 80
################################################################################
#   #    #     #                                      #           #        #   #
#   #    #     #                                      #           #        #   #
#   #    #     #                                      #           #        #   #
#   #    #     #                                                  #        #   #
#   #    #     #                                                  #        #   #
#   #    #     #                                                  #            #
#   #    #     #                                                  #            #
#   #    #     #########    ##################################### #            #
#   #    #     #    #          #      #        #                  #            #
#   #    #     #    #          #      #        #                  #        #   #
#   #    #     #    #          #               #                  #        #   #
#   #    #     #    #          #               #                  #        #   #
#   #    #     #    ######     ####         ## #           #      #        #   #
#        #     #    #     #    #               #           #      #        #   #
#        #     #          #    #      #        ##    ##### #      #        #   #
#        #     #          #    #      #        #     #     #      #        #   #
#        #     #          #    #      #        #           #      #        #   #
#   #    #     #               #               #           #      #        #   #
#   #    #     #    #          ###    ######## #           #      #        #   #
#   #    #     #    #          #                           #      ####     #   #
#   #    #     #    #          #                     #     #      #        #   #
#   #    #     #    #     #    #                     #     #      #        #   #
#   #    #     #    ###   #    #                                  #        #   #
#   #    #     #    #     #    #          #    ###############    #            #
#   #    #     #    #     #    #    #     #    #           #      ##########   #
#   #    #     #    #     #    #    ####    ## #                  #       #    #
#   #    #     #    #     #    #    #          #                  #       #    #
#   #    ###   #          #    #    #          #                  #       #    #
#   #    #     ########    ### #    #          #########          #       #    #
#   #    #     #     #    #    #    #          #           #      #            #
#   #    #     #     #    #    #    #     #    #           #      #            #
#   #    #     #     #    #         #     #    #           #      #            #
#   #    #     #     #    #         #     #    #     #     #      #            #
#   #    #     #     #    #         #     #    #     #     #      #       #    #
#   #    #     ##    #    #         #     #    #     #     #      #       #    #
#   #    #     #     #         #    #                             #       #    #
#        #     #     #         ###    ########################### #       #    #
#  ##### #     #     #      *  #                            #     #       #    #
#   #          #               #                            #             #    #
#   #          #          #    #                            #             ##   #
#   #          #          #    #                                      ### #    #
#              ###    ### #    #                                          #    #
#        #     #     #    #    #    ##                            #       #    #
#        #     #     #    #    #     #                            #       #    #
#        #     #     #    #    #     #                            #       #    #
#        #     #     #    #    #     ###########    ############# #       #    #
#######    ### #          #    #     #                            #       #    #
#    #         #          #    #     #                            #       #    #
#    #         #          #    #     #                            #       #    #
#    #         #                                                               #
#    #    #    ########################################    #####################
#    #    #    #     #    #                    #     #    #     #    #     #   #
#    #    #    #     #    #                    #     #    #     #    #         #
#    #    #    #          #                    #     #    #     #    #         #
#    #    #    #          #                    #     #    #          #         #
#    ###    ## #          #    #   ########### #     #    #          #         #
#    #    #    ########   #    #               #     #    #          #######   #
#    #    #    #     #    #    #               #           ###    ## #     #   #
#    #    #    #     #         #                                           #   #
#    #    #    #     #         #                                               #
#    #    #    #     #     ####    ############                                #
##   #         #     #                  #       #######   #                    #
#    #         #     #    #                    #     #    #################    #
#    #         #     #    #                    #     #    #                    #
#    #         #     #    #                    #     #    #                    #
#    #    #    #          #                    #          #                    #
#    #    #    #          #             #      #          #                    #
#    #    #    #          #             #      #                               #
#    #    #    #                               ##########################    ###
#         #    #   ########################### #          #                    #
#         #                           #        #          #                    #
#         #                           #        #          #                    #
#         #                           #        #          #                    #
#    #    #                           #        ######     ###############    ###
#    #    #    ######    ############# #####   #          #                    #
#    #    #    #                               #          #                    #
#    #    #    #                               #                               #
#    #    #    #                               #                  #            #
################################################################################
