80 80
################################################################################
#    #    #    #                               #                               #
#    #    #    #                                                               #
#    #    #    #                                                               #
#    #    #    #                                                               #
#    #    #     ##################    ##########################################
#    #    #           #         #     #          #      #      #     #     #   #
#    #    #           #         #     #          #      #      #     #     #   #
#         #           #         #     #          #      #      #     #     #   #
#         #    #      #         #     #                 #      #     #     #   #
#         #    #      #         #     #                 #            #     #   #
#         #    #      ###    ## ##    #                 #            #     #   #
#    #    #    #      #               #                 #            #     #   #
#    #    #    #      #               #          #      #                  #   #
#    #    #    #      #               #          #      #      #           #   #
#    #    #    #      #               #          #      #      #           #   #
#    #    #    #      #############   #          #      #   ## ###    #### #   #
#    #    #    #      #     #    #    #          #      #      #           #   #
#    #    #    #      #          #    #####      #      #      #               #
#    #    #    #      #          #    #          #      #      #               #
#    #    #    #      #               #          #      #                      #
#    #    #    #      #               #          #      ############    ###    #
#    #    #    #      ########                   #      #      #           #   #
#    #    #    #      #                          #      #      #           #   #
#    #    #    #      #          #               ##     #      #           #   #
#    #    #    #      #          #               #      #      #           #   #
#         #    #      #          #    #          #      #      #           #   #
#    #### #    #      #          #    #          #      #      #      #    #   #
#   #     #    #      #                          #      #      #      #    #   #
#   #     #    #      #################    ##### #      #      #      #    #   #
#         #    ##     #     #    #      #        #      #      #      #    #   #
#         #    #      #     #    #      #        #      #      #      #    #   #
#              #      #     #           #        #      #      ####   #    #   #
#              #      #     #           #        #      #      #      #    #   #
#   #          #      #     #           #        #      #      #      #    #   #
#   #          #      #                 #        #      #      #      #    #   #
#   #     #    #      #          #               #      #      #      #    #   #
#   #     #    #      ###        #               #      #      #      #    #   #
#   #     #    #      #          #               #      #      #      #    #   #
#   #     #    #      #     #    #       ####    #      #      #           #   #
#   #     #    #      #     #    #   ## #        #             ##    ##### #   #
#   #     #    #      #     #    #      #        #             #     #     #   #
#   #     #    #      #     #    #      #        #             #     #     #   #
#   #     #    #      #     #    #      #        #             #     #     #   #
#   #     #    #      #     #    #      #        #      #      #     #     #   #
#              #      #     #    #      #        #      #            #     #   #
#  ########### #      #     #    #      #        #      #            ###   #   #
#   #          #      #     #    #      #        #      #                  #   #
#              #      ####    ## #      #        #      #                  #   #
#              #      #    *#    #      #        #      #      #           #   #
#              #            #    #               #      #      #           #   #
#        #     #            #    ##    ######### #      #                      #
#   #    #     #            #    #         #     #      #############    #######
#   #    #     #            #    #         #     #      #                      #
#   #    #     #      ###        #               #      #                      #
#        #     #      #          #               #      #                      #
#   #### #     #      #          #               #                             #
#   #    #     #      #          #               #############    ##############
#   #    #     #      #                          #          #     #            #
#   #    ##    ####    ######################### #                #            #
#   #    #     #        #    #                   #                #            #
#   #    #     #        #    #                   #                #            #
#   #    #     #        #    #                   #                #      #     #
#        #     #             #                   ######    #######    ## #     #
#        #     #             #                   #                       #     #
#        #     ######        #################   #                       ####  #
#        #     #             #     #      #      #                       #     #
#   #    #     #        #    #            #      #                       #     #
#   #    #     #        #    #            #      #####    ############## #     #
#   #    #     #        #                        #                       #     #
#   #    #     #        #                        #                       #     #
#   #    #     #######    ###      #             #                       #     #
#   #    #     #                   #             #                #      #     #
#   #    #     #             ###   ###########   #                #      #     #
#   #    #     #             #     #             #    ########### #      #     #
#   #    #     #             #     #             #                #      #     #
#   #    #     #             #     #             #                #      #     #
#   #    #     #        #    #     #             #                #      #     #
#   #    #     #        #    #     #     #       #           #    #      #     #
################################################################################
