80 80
################################################################################
#                    #                                       #     #    #      #
#                    #                                       #     #    #      #
#                    #                                             #    #      #
#                    #                                             #    #      #
##########    ###### #                                             #    #      #
#            #       #####    ###############################      #    #      #
#            #       #                 #                     #     #    #      #
#            #       #                 #                     #     #    #      #
#     #      #       #                 #                     #     #    #      #
#     #      #       #                 #      #              #     #    #      #
#     #      #       #         #       #      #              ###   #    #      #
#     #      #       #         #              ##    ######## #     #    #      #
#     #      #       #         #              #              #     #    #      #
#     #      #       #         #              #              #     #    ####   #
#     #      #    ## #         #              #              #          #      #
#     #      #       #         ####    ###### #         #    #          #      #
#     #      #       #         #              #         #    #          #      #
#     #      #       #    #### #              #         #    #          #      #
#     #      #       #         #              #         #    #          #      #
#     #      #       #         #                             #   ###### #      #
#     #              #         ##    ####################### #     #    #      #
#     #              #         #      #      #        #      #                 #
#     #              #         #      #      #        #      #                 #
#     #                        #      #               #      #                 #
#     #      #                 #                      #      #                 #
#     #      #                 #                      #      #     #    #      #
#     #      #                 #                      #      #     #    #      #
#     #######    ### #         #             #        #      #     #    #      #
#     #        #     #         #      #      #        #   ## ##    #    #      #
#     #        #     #         #      #      #        #      #     #    #      #
#     #        #     #         ###    #      #        #      #     #    #      #
#     #        #     #         #      #      #        #      #     #    #      #
#     #        #     #         #      #      ###    ##       #                 #
#     #        #     #         #      #      #               #    ##############
#     #        #     #         #      #      #               #             #   #
#     #        #     #         ####### *  ## #               #             #   #
#     #        #     #         #             #               #             #   #
#     #        #     #         #             ##    ######### #                 #
#     #        #     #         #             #               #                 #
#     #        #     #         #             #               #                 #
#     #        #     #         #             #               #                 #
#     #        #     #                                                         #
#     #        #     ####    ###################################################
#     #        #     #         #                     #          #      #       #
#     #        #     #         #                     #          #      #       #
#     #        #     #         #                     #          #      #       #
#     #        #     #         #                     #     #    #      #       #
#     #        #     #         #    #        #       #     #                   #
#     #        #     #         #    #        #       #     #                   #
#     #        #     #         #    #        ##      ###   #            #####  #
#     #        #     #         #    #        #       #     #                   #
#     #              #         #    #        #       #     #    #      #       #
#     #              #         #    #    ### #             #    #      #       #
#     #              #         #    #        #                  #              #
#     #              #         #    #        #            ##### ##    ##########
#     #        #     #         #    #        #             #    #              #
#     #        #     #         #    #        #       #     #    #              #
#     #        #     #         #    #                #     #    #              #
#     #        #     ##    ### #    #####    ####### #     #    #              #
#     #        #     #         #    #                #   ##     #       #      #
#     #        #     #         #    #                #          #       #      #
#     #        #     #         #    #                #          #       #      #
#     #        #     #              #                #          #       #      #
#     #        #     #              #           #    #          #       #      #
#     ######   #     #              #           #               #       #      #
#     #        #     #              #########    ############## #       #      #
#     #        #     #              #            #              #       #      #
#     #        #     #######    ### #            #              #   ### #   ####
#     #        #     #      #       #            #              #       #      #
#     #        #     #      #       #                           #       #      #
#     #        #     #      #       #                           #       #      #
#     #        #     #      #       #                                   #      #
#     #        #     #      #       ####################################    ####
#     #        #     #      #####   #                                  #       #
#     #        #     ####   #       #                                  #       #
#     #        #     #      #       #                                  #       #
#     #        #     #              #                                          #
#     #        #     #              #                                          #
################################################################################
