80 80
################################################################################
#     #         #    #      #      #     #    #    #                           #
#               #    #      #      #     #    #                                #
#               #    #      #      #     #    #                                #
#   ##     #         #      #      #     #    #     ###########    #############
#          #                #      #     #    #                                #
#     #    #                #      #     #    #    #                           #
#     #    #                #      #     #    #    #                           #
#     #    #    #           #      #     #    #    #                           #
#     #         #######     #      #     #    #                                #
#     ######    #      #    #      #     #    #    #############################
#     #    #    #      #    #      #     #    #    #    #    #    #    #       #
#     #    #    #           #      #     #    #    #    #    #    #    #       #
#     #    #    #                  #     #    #    #    #         #    #       #
#     #    #    ###                #     #    #    #    #         #            #
#     #         #                  #     #    #    #    #         #            #
#     #         #      #           #     #    #    #    #         #     ####   #
#     #         #      #    #      #     #    #         #    #    #            #
#     #         #           #            #    #         #    #    #    #       #
#     ##########    ####### #            #    #         #    #    #    #       #
#     #                     #            #    #         #    #    #    #       #
#     #                     #            #    #    #    #    #    #####    #####
#     #                     #      #     #    #    #    #    #    #       #    #
#                           ###    #          #    #    #    #    #       #    #
######################      #      #          #    #    #    #    #       #    #
#    #      #       #       #      #          #    #    #    #    #       #    #
#    #      #       #       #      #          #    #    #    #    #       #    #
#    #      #       #       #      #     #    #         #    #    #       #    #
#    #      #       #       #      #     #    #   ##### #    #    #       #    #
#    #      #            ## #      ####    ## #    #    #    #    #       #    #
#    #      #               #      #     #         #    #    #    #            #
#    #      #               #      #     #         #    #    #    #            #
#    ##     #               #      #     #         #    #    #    #            #
#    #      #       #       #      #               #    #    #    #            #
#    #      #       #       #      #          #    #    #    #    #####   #    #
#    #      #       #       #      #          #    #    #    #    #       #    #
#           #       #       #      #          #    #    #    #    #       #    #
#           #       #       #      #     #    #    #    #    #    #       #    #
#           #####   #       #      #     #    #         #         #       #    #
#           #       #       #      #     #    #         #   ##### #       #    #
#    #      #       #       #      #     #    #         #    #    #       #    #
#    #      #       #       #      #     #    #         #                 #    #
#    #      #       #       #      #     #    #    #                      #    #
#    #      #       #       #      #     #    #    #                      #    #
#    #      #       #       #      #     #    #    #                      #    #
#    #      #       #       #      #     #    #    #     #################    ##
#    #      #       #       #      #     #    #    #    #                      #
#           #       #       #      #     #    #    #    #                      #
######      #       #       #                 #    #    #                      #
#     #     #       #       #   ############# #    #    #          #           #
#     #      ####    ###### #     #           #    #    ###    ### #####    ####
#     #          #    #     #     #           #    #    #          #           #
#     #          #    #     #                 #    #    #          #           #
#                #          #                 #    #    #          #           #
#           #    #          #                                                  #
#           #    #     ##   ############################################    ####
#           #    #          #    #                       #      #              #
#     #     #    #    #     #    #                       #                     #
#     #     #    #    #     #    #                                             #
#     #     #    #    #     #    #                                             #
#     #     #    #    #     #    ###################                           #
#  ## ###   #    #          #                                                  #
#     #     #    #    ##### #                            #                     #
#     #     #    #    #     #                            ###########    ########
#     #     #    #    #     #                            #      #     #    #   #
#     #     #    #    #     #                            #      #     #    #   #
#     #     #    #    #     ########    ################ #            #    #   #
#     #     #    #    #     #      #            #        #            #    #   #
#     #     #    #    #     #                   #        ###          #    #   #
#     #     #    #    #     #                            #            #    #   #
#     #     #    #          #                            #      #     #    #   #
#     #     #               #                            #      #              #
#     #     #               #                            #      #              #
#     #     #               #                   #        #                     #
#     #     #         #     ############    ### #        ########           ####
#     #     #    #    #     #                   ##    ## #            #        #
#     #     #    #    #     #                   #        #            #        #
#     #     #    #    #     #                   #        #            #        #
#     #     #    #    #     #           #       #        #     #      #*       #
################################################################################
