80 80
################################################################################
#           #     #                  #              #                          #
#           #     #                  #              #                          #
#     #     #     #                  #              #                          #
#     #     #     #                  #              #                          #
###   #     #     ############    ## ##########    ##                          #
#     #     #                #       #       #       #############    ##########
#     #     #                #       #                                         #
#     #     #                #       #                                         #
#     #     #                        #                                         #
#     #     #                        #                                         #
#     #     #                        ##############################    #########
#     #     #################    ### #                                         #
####    ### #                        #                                         #
#           #                        #                                         #
#           #                        #                                         #
#           #     #                   #####################    ###### ##    ####
#           #     #                                                   #        #
#           #     #                                                   #        #
#     #     #     #                                                   #        #
#     #     #                                                                  #
#     #     ###########################################    #####################
#     #     #    #    #    #                                          #    #   #
#     #     #    #    #    #                                          #    #   #
#     #     #    #    #    #                                          #        #
#     #     #    #    #    #          #                               #        #
#     #     #    #    #    #     #    #   ############################         #
#     #     #    #    #    #     #    #                       #                #
#     #     #    #    #    #     #    #                       #                #
#     #     #    #    #    ###    ### #                                        #
#     #     #    #    #    #          #                               #######  #
#     #     #    #    #    #          #          *                    #    #   #
#     #     #    #    #    #          #                               #    #   #
#     #     #    #    #    #          #                               #    #   #
#     #     #    #    #    ###########    ########################### #    #   #
#     #     #    #    #    #                      #      #            #    #   #
#     #     #    #    #    #                             #            #    #   #
#     #     #    #    #    #                                          #    #   #
#     #     #    #    #    #          #                               #    #   #
#     #     #    #    #    #######    ######    ##                    #    #   #
#     #     #    #    #    #          #           #                   #    #   #
#     #     #    #    #    #          #           #                   #    #   #
#     #     #    #    #    #          #           #                   #    #   #
#     #     #    #    #    #          #           #################   #    #   #
#     #     #    #    #    #     #                #         #         #    #   #
#     #     #    #    #          ################ #         #         #    #   #
#     #     #    #    #                           #         #         #    #   #
#     #     #    #    #                           #         #         #    #   #
#     #     #    #    #                           #                   #    #   #
#     #     #    #    #    #               #      #                   #        #
#     #     #    #    #    #               #      #                   #        #
#     #     #    #    #    #                      #                            #
#     #     #    #    #    ####################    #############################
#     #     #    #    #    #                                                   #
#     #     #    #    #    #                                                   #
#     #     #    #    #    #                                                   #
#     #     #    #    #    #                                                   #
#     #     #    #         #                                                   #
#     #     #    #                                                             #
#     #     #          ######################################    ###############
#     #     #                  #                            #                  #
#     #     #         #        #                                               #
#     #     #         #        #                                               #
#     #     #         #        #                                               #
#     #      ##    ## #        #                                               #
#     #          #    #        ##############    ###############################
#     #          #    #        #               #                           #   #
#     #          #    #        #               #                               #
#     #     #    #    ######   #               #                               #
#     #     #    #    #        #               #                      #        #
#     #     #    #    #        #############   ##########    ######## #        #
#     #     #    #    #        #               #                      ###    ###
#     #     #    #    #        #                                      #    #   #
#     #     #    #    #                                               #    #   #
#     ##    #    #    #                                               #    #   #
#     #     #    #    #         ##    ############################### #    #   #
#     #     #         #                                               #        #
#     #     #         #        #                                      #        #
#     #     #         #        #                                      #        #
################################################################################
