80 80
################################################################################
#                                         #     #    #    #               #    #
#                                               #    #    #               #    #
#                                               #    #    #               #    #
#                                               #    #    #############   ##   #
############################    ############### #    #    #               #    #
#     #       #           #    #    #    #      #    #    #               #    #
#     #       #                #    #    #      #    #    #                    #
#     #       #                #    #    #      #    #    #                    #
#     #       #                #    #    #      #    #    #                    #
#     #       #                #    #    #      #    #    #   ##################
#     #       ##########    ## #    #    #      #    #    #       #            #
#     #       #      #    #    #    #    #      #    #    #       #            #
#     ###     #      #    #    #    #    #      #    #    #       #            #
#     #       #      #    #    #    #    #      #    #    #       #            #
#     #       #      #    #    #    #           #    #    #       ###########  #
#     #       #      #    #    #    #           #    #    #       #            #
#     #       #      #    #    #    #           #    #    #       #            #
#     #       #      #    #    #    #           #    #    #       #            #
#     #       #      #    #    #    #    #      #    #    #       #      #     #
#     #       #      #    #    #         #      #    #    #       #      #     #
#     #       #      #    #    #         #      #    #    #       #      #     #
#     #       #      #    #    #         #      #    #    #       #      #     #
#     #       #      #    #    #         #      #    #    #       #      #     #
#     #       #      #    #    #    #    #      #    #    #       #      #     #
#     #       #      #    #    #    #    #           #    #       #      #     #
#     #       #      #    #    #    #    #           #    #       #      #     #
#     #       #      #    #    #    #    #           #    #       #      #     #
#     #       #      #    #         #    #           #    #       #      #     #
#     #       #      #    #         #    #      #    #    #       #      #     #
#     #       #      #              #    #      #    #    #       #      #     #
#     #       #      #              #    #      #    #    #       #      #     #
#     #       ##     #         #    #    #      #    #    #       #      #     #
#     #       #      #         #    #    #      #    #    #       #      #     #
#     #       #      #    #    #    #    #      #    #    #       #      #     #
#     #       #      #    #    #    #    #      #    #    #       #      #     #
#     #       #      #    #    #    #    #      #         #       #      #     #
#     #       #           #    #         #      #         #       #      #     #
#     #       #           #    #   ##### #      #         #       #      #     #
#     #       #           #    #    #    #      #   ##### #       #      #     #
#     #       #           #    #    #    #      #    #    #       #      ###   #
#     #              #    #    #    #    #      #    #    #       #      #     #
#     #              #    #    #    #    #      #    #    #       #      #     #
#     #              #    #    #    #    #      #    #    #              #     #
#     #              #    #    #    #    #      #    #    #              #     #
#     #       #      #    #    #    #    #      #    #    #              #     #
#     #       #      #    #    #    #    #      #    #    #              #     #
#     #       #      #    #    #    #    #      #         #       #      #     #
#     #       #      #    #    #    #    #      #         #       #      #     #
#     #       #      #    #    #    #    #      #         ##      #      #     #
#     #       #      #    #    #    #    #      #         #       #      #     #
#     #       #      #    #    #    #    #      #    #    #       #      #     #
#     #       #      #    #    #    #    #      #    #    #       #      #     #
#             #      #    #    #   *#    #      #    #            #      #     #
#             #      #    #    #         #      #    #            #      #     #
#             #      #    #    #         #      #    #            #      #     #
#             #      #    #    #         #      #                 #            #
#     #       #      #    #    #         #      ##################    ##########
#     #       #      #    #    #    #    #      #     #     #         #        #
#     #       #      #    #    #    #    #      #     #     #                  #
#     #       #      #    #    #    #           #     #     #                  #
#     #       #      #    #    ##    ########## #     #     #                  #
#             #      #    #    #     #     #    #     ##    #                  #
##    ####### #      #    #    #     #     #    #     #     #                  #
#   #    #    #      ###    ## #     #     #    #     #      ####    ###########
#   #         #      #    #    #           #    #     #                    #   #
#   #         #      #    #    #           #    #     #                        #
#   #         #      #    #    #           #    #     #                        #
#   #         #      #    #    ###    ##   #    #     #     #                  #
#   #         #      #    #    #     #     #    #     #     #                  #
#    ##    ## #      #    #    #     #     #    #      ##    ###################
#             #      #         #     #     #    #                              #
#             #      #         #           #    #                              #
#             #      #         #########   #    #                              #
#                    #         #      #    #    #     #                    #   #
###################    ####### #      #    #    #     ###########    ##### #   #
#                              #      #    #    #     #                    #   #
#                              #                #     #                    #   #
#                              #                #     #                    #   #
################################################################################
