80 80
################################################################################
#                                                   #    #    #    #     #     #
#                                                   #    #    #    #     #     #
#                                                   #    #    #    #     #     #
#                                                   #         #    #     #     #
################################################    #         #    ###   #     #
#                                        #          #         #    #     #     #
#                                        #          ###    ## #    #     #     #
#                                        #               #    #    #     ###   #
#                                  #                     #    #    #           #
##    ############################ #                     #    #                #
#                                  #                     #    #                #
#                                  #######    ##### #    #    #                #
#                                  #                #    #    #          #     #
#                                  #                #         #    #     #     #
#     #                            #                #         #    ##### #     #
#     #                            #                #         #     #    #     #
#                                                             #     #    #     #
###########    ############################################## #     #    #     #
#      #     #     #         #                                #     #    #     #
#      #     #     #         #                                ###   #    #     #
#      #     #     #         #                                #          #     #
#      #     #     #         #           #                    #          #     #
#      ###   ###        #    ######      #        #           #          #     #
#      #                #    #           #        #           #          #     #
####   #                #    #           #                    ###########    ###
#      #                #    #           ####    ############ #          #     #
#      #           #    #    #           #                    #          #     #
#      #           #    #    #           #                    #                #
#      ####    ### #    #    #     #     #                    #     #          #
#                  #    #    #     ###   #             #      #     #          #
#                  ###    ## ###   #     ####    ##### ###    #     #          #
#                  #    #    #     #     #             #      #     #    #     #
#                  #    #    #     #     #             #      #     #    #     #
#      #     #     #    #    #     #     #             #      #     #    #     #
#      #     #     #    #    #                         #      #          #     #
#      #     #     #         #######################    ##### #######    #     #
#      #           #         #     #    #      #        #     #     #    #     #
#####    ######### #         #     #    #      #        #     #     #    #     #
#   #        #     #         #     #    #               #     #     #    #     #
#   #        #     #    #    #     #    #                     #     #    #     #
#   #        #     #    #    #     #    #                     #     #    #     #
#   #              #    #    #     #    #       ###           #     #    #     #
#   #              #    #    #     #    #      #              #     #    #     #
#                  #    #          #    #      #        #     #     #    #     #
#                  #    #          #    #      #        #     #     #    #     #
#    ##      #     #    #          #    #      #        #     #     #    #     #
#            #     #    #          #    #   ## #        #     #     #    #     #
#   #        #     #    #    #     #    #      #        #     #     #    #     #
#   #        #     #    #    #     #    #      #        #     #          #     #
#   #        #     #    #    #     #    #      #        #     #          #     #
#            ###   #    #    #          #      #        #     #          #     #
#  ######### #     #    #    #          #      #        #     ###        #     #
#   #        #     #    #    #          #      #        #     #     #    #     #
#            #     #    #    #          #      #        #     #     #    #     #
#            #     #    #    #          #      #        #     #     #    #     #
#            #     #    #    #    ##### #      #        ##    #     #    #     #
#            #     #    #    #    #     #      #        #     #     #    #     #
#                  #         #    #     #      #        #     #     #    #     #
################    ######## #    #     #      #        #     #     #    #     #
#    #     #    #            #    #     #      #        #     #     #    #     #
#    #     #    #            #    #     #      #        #     #     #    #     #
#    #     #    #            #    #      ######    #### #     #     #    #     #
#          #                 #    #                     #     #     #    #     #
#          #                 #    #                     #     #     #    #     #
#          #                 #    #                     #     #     #    #     #
#                            #    #     #                     #     #    #     #
#    #                       #    #     ###    ###############      #    #     #
#    #      ##########    ## #          #                #          #    #     #
#               #            #          #                #          #    #     #
######    ##    #            #          #                #          #    #     #
#          #    #            #          #          #          #     #    #     #
#          #    #            #    #     #          #          #     #    #     #
#          #    #            #    #     ####    ## #          #     #    #     #
#     #    #    #            #    #     #     #    #          #     #    #     #
#     #    #     ########    #    #     #     #    ######     #     #    ###   #
#     #    #                 #    #     #     #    #          #     #    #     #
#     #    #                 #    #     #         *#          #     #    #     #
#     #    #                 #    #     #          #          #     #    #     #
################################################################################
