80 80
################################################################################
#             #            #    #           #       #             #    #       #
#             #            #    #           #       #             #    #       #
#             #            #    #           #               #          #       #
#                          #    #           #               #          #       #
#                          #    #           ##    ## ###    #          #       #
#                          #                #               #          #    ####
######    ################ #                #       #       #     #    #       #
#     #    #       #       #                #       #       #     #            #
#     #    #       #       ##    ########## #       #       #     #            #
#     #    #       #       #      #    #    #               ##    #            #
#     #    #       #       #      #    #    #########    ## #     #            #
#          #       #       #      #    #    #               #     #    #       #
#          #       #       #      #         #               #     #    #       #
#          #       #       #      #                         #     #    #       #
#          #       #       ####   #                               #    #       #
#     #    #   ### #       #      #          #####    ########### #    #       #
#     #    #       #       #      #    #                     #    #    #       #
#     #    #       #       #      #    #    #                     #    #       #
#     #            #       #      #    #    #                     #    #       #
#     #            #       #      #####     #    #                #    #       #
#     #            #       #      #    #    #    #                #    #       #
#     ########     #       #      #    #    #    #           #    #    #       #
#     #      #     #       #      #         #    #           #    #            #
#     #      #     #       #                #                #    ##########   #
#     #      #     #       #                ###########      #    #            #
#     #      #     #       #                #                #    #            #
#  ## #      #     #       #           #    #                #    #            #
#     #      #     #       #      #    #    #                #    #            #
#     #      #     #       #      #    #    #                #    #       #    #
#     #      #     #              #    #    #                #    #       #    #
#     #      #     #                                              #####   #    #
#     #      #     #        ###################################   #       #    #
#     #      #     #   ####              #                        #       #    #
#     #      #     #       #             #                        #       ##   #
#     #      #     #       #                                      #       #    #
#     #      #             #                                   *  #       #    #
#     #      #             #                                      #       #    #
#     #      #             #                                                   #
#     #      #             ##########    #######################################
#     #      #     #       #               #    #        #    #            #   #
#     #      #     #       #               #    #        #    #                #
#     #      #     #       #               #    #        #    #                #
#     #            #       #                    #        #    #                #
#     #            #       #    #               #        #    ####    #####    #
#     #            #       #    #               #        #    #            #   #
#     #            #       #                    ###      #    #            #   #
#     #      #     #       #########    ## #    #             #            #   #
#     #      #     #       #    #          #    #             #     #      #   #
#     #      #     #       #    #          #    #             #     #      #   #
#     ####   #     #       #    #          #    #             #                #
#     #      #     #       #    #          #    #             ###############  #
#     #      #     #       #    #     #    #    ###########   #       #    #   #
#     #      #     #       #    #     #    #    #    #        #       #    #   #
#     #      #     #       #    #     #    #    #    #        #       #        #
#     #      #     #       #    #     #    #    #    #        #       #        #
#     #      #     #       #    #     #    #    #             #       #        #
#     #      #     #       #    #     #    #    #             #       #        #
#     #      #     #       #    #     #    #    #     #####   #           ######
#     #      #     #       #    #     #    #    #             #                #
#     #      #     #       #    #     #    #    #    #        #   ####         #
#     #      #     #       #    #          #    #    #                         #
#     #      #     #       #    #######    #    #    #                #        #
#     #      #     #       #    #    #     #    #    #                #    #   #
#     #      #     #       #    #    #     #    #    #                #    #   #
#     #      #     #       #    #    #     #    #    #                #    #   #
#     #      #     #       #    #    #     #    #                              #
#     #      #     #       #    #    #     #    ################    ############
#     #      #     #       #    #    ###   #    #         #            #       #
#     #      #     #       #         #     #    #                      #       #
#     #      #     #       #               #    #                      #       #
#     #      #     #       #               #    #                      #       #
#     #      #     #       #               #    #                              #
#     #      #     #       #    #          #    ############      #            #
#     #            #       #    #               #                 #            #
####    ########## #       ##    ###############                  ##    ########
#                  #       #                                      #            #
#                  #       #                                      #            #
#                  #       #                             #        #            #
################################################################################
