80 80
################################################################################
#                         #    #        #      #           #        #    #     #
#                         #    #               #           #        #    #     #
#                         #    #               #           #        #    #     #
#        #                #     ####        ## #      #    #        #    #     #
#        #                #                    #      #    #        #    #     #
#                         #             #      #####    ## ###    ##           #
###########    ########## #             #      #      #    #                   #
#                 #       #    #               #      #                        #
#                 #            ####    ####### #      #                        #
#                 #            #                      #             #    #    ##
#                              #                                    #    #     #
#      #                       #                           #        #    #     #
#      #                  #    #                           #        #    #     #
#      ############    ## #    #               #           #        #    #     #
#      #      #     #     #                    #           #        #    #     #
#      #      #     #     ##################   #                    #    #     #
#      #      #     #     #     #         #    ########    ######## #    #     #
#      #                  #     #              #                    #    #     #
#      #                  #     #              #                    #    #     #
#      #                  #                    #                    #    #     #
#      #                  #          #         #       #            #    #     #
#      #      #           #          #    #    ##      ##    ###### ##    ######
#      #      #           #          #    #### #       #            #          #
#      ###    #   ####### #          #    #    #       #            #          #
#   ## #      #      #    ###    ### #         #       #            #          #
#      #      #           #          #         #                               #
#      #      #           #          #         #######################    ######
#      #      #           #          #         #      #    #               #   #
#      #      #           #          #    #    #      #    #               #   #
#      #      #           #          #    #    #      #    #               #   #
#             #                                #      #    #               #   #
############    ############################## #      #    #############   #   #
#     #                                 #      #      #    #     #         #   #
#     #                                 #      #      #    #                   #
#                                       #      ##     #    #                   #
#                              #        #      #      #    #                   #
#                              #        #      #      #    #                   #
#                              #        #      #      #          #         #   #
#     ######################    ####### #      #      #          #         #   #
##    #                                 #      #      #          #             #
#     #                                 #      #      #     #####    ###########
#     #                                 #      #      #    #        #     #    #
#     #                                 #      #      #    #        #     #    #
#     #                                        #      #    #        #          #
#                                              #      #  * #        #          #
########    ############################       #      #    #        #          #
#              #         #     #               #      #    #        #   ##     #
#                        #     #        #      #      #    #        #     ###  #
#                        #     #        #      #      #    #        #     #    #
#   #               #    #     #        #      #      #    #        #     #    #
#   #               #          #        #      #      #    #        #     #    #
#   #               #          #        #      #      #    #        #     #    #
#   #               #          #        #      #      #    #        #     #    #
#   ##    ######### #          #        #      #      #    #        #          #
#   #               #          #        #      #      #    #        #########  #
#   #               #####      #        #      #      #    #        #    #     #
#   #               #          #        #      #      #    #        #    #     #
#   #      #        #          #        #      #      #    #        #    #     #
#   #      #        #          #        #      #      #    #        #    #     #
#   #               #          #        #      #      #    #        #    #     #
#   #############    ##########         ###    #      #    ##    ## #    #     #
#   #            #                      #      #           #        #          #
#   #            #                      #      #           #        #          #
#   #            #              ####    #      #           #        #          #
#   #            #             #        #      #           #        #          #
#   #                          #        #      #      #    #        #    #     #
#   #                          #        #      #      #    #             #     #
#   #                                   #      #      #    #             ####  #
#   #############    ################## #      #      #    #             #     #
#   #                        #          #      #      #    #             #     #
#   #                        #          #      #      #    #        #    #     #
#   #                                   #      #      #    #        #    #     #
#   #                                   #      #      #    #        #    #     #
#   #        #                #####     #      ####    ### #        #    #     #
#   ##########    ###########     #     #      #           #        #    #     #
#   #                        #    #     #      #           #        #    #     #
#   #                        #          #      #           #        #    #     #
#   #                        #          #      #     #     #        #    #     #
################################################################################
