80 80
################################################################################
#                #      #    #            #    #    #        #       #         #
#                #      #    #            #    #    #        #       #         #
#                #      #    #            #    #             #                 #
#                #      #     ###    #### #    #             #                 #
#      #         #      #          #      #    #             ###      ######   #
#      #         #      #          #      #    #             #                 #
#      #         #      #                 #    #             #       #         #
####    ######## #      #                 #    #             #       #         #
#   #      #     #      #                 #    ###########   #                 #
#   #      #     ###    ######    ####### #    #      #      #   ###############
#   #      #     #      #                 #           #      #    #      #     #
#   #      #     #      #                 #           #           #      #     #
#   #      #     #      #                 #           #           #      #     #
#   #      #     #      #                             #           #      #     #
#   #      #     #      ###      ##    ###     #      #           ###    #     #
#    ##    #     #      #        #             #      #      #    #      #     #
#          #     #               #             #      #      #    #      #     #
#          #                     #        #    #      #   ## #    #      #     #
#          #                              #    ####   #      #    #      #     #
#   #      #      ######    ############# #    #      #      #    #      #     #
#   #      #                              #    #      #      #    #      #     #
#   #      #     #                        #    #      #      #    #      #     #
#   #      #     #                        #    #      #      #           #     #
#   #            #                        #    #      #      #           #     #
#   #            #                        #    #      #      #           #     #
#   #            #                             #      #      #########   #     #
#   #            ##########################    #      #      #    #      #     #
#   #      #     #               #    #        #      #      #           #     #
#   #      #     #               #    #        #      #      #           #     #
#   #      #     #               #    #        #      #      #                 #
#   #      #     #        #      #    #        #      #      #     ###         #
#   #      #     #        #      #    #        #      #      #    #            #
#   #      #     #        #      #    #        #      #      #    #            #
#   #      #     #    ### #      #             #             #    #      #     #
#   #      #     #        #      #             #             #    #      #     #
#   #      #     #        #      #             #             #    #      #     #
#   #      #     #        #      #             #             #    #      #     #
#   #      #     #        #      #    #        #             #    #      #     #
#   #      #     #        #      #    #        #                  #            #
#   #      ###   #        #      #    #        ################    #############
#   #      #     #        ##     #    #        #    #               #     #    #
#   #      #     #        #      #    #        #    #               #     #    #
#   #      #     #        #      #    #        #                    #     #    #
#   #      #     #        #      #    #        #                    #     #    #
#   #      #     #        #      #    #        #                          #    #
#   #      #     #        #      #    #        #                          #    #
#   #      #     #        #      #    #        #    #                     #    #
#   #      #     #        #      #    #        #    #                     #    #
#   #      #     #        #      #    #        #####    ########### #     #    #
#   #      #     #               #    #        #                    #     #    #
#   #      #     #####    ###### #    #        #                    #     #    #
#   #      #     #         #     #    #        #                    #     #    #
#   #      #     #         #     #    #        #                          #    #
#   #      #     #         #     #    #    ### ############    ########## #   ##
#   #            #         #     #    #        #                #    #    #    #
#   #   ######## #         #     #    #        #                     #         #
#   #    #       #         #     #    #        #                     #         #
#   #    #       #               #             #           #         #         #
#   #    #       #               ######    ### #     #     #         #         #
#   #    #       #               #             #     #     #         #    #    #
#   #    #       #               #             ####    ### #         #    #    #
#   #    #       #         #     #             #     #     #    #### #    #    #
#   #    ##      #         #     #        #    #     #     #    #    #    #    #
#   #            #         #     #        #    #     #     #         #    #    #
#   #            ####      #     #        #    #     #     #              #    #
#   #            #         #     #        #    #     #     #              #    #
#   #            #         #     ##    ## #    #           #              #    #
#   #    #       #         #     #        #    #           #    #         #    #
#   #    #       #         #              #    #           #    #    #    #    #
#   #    #       #         #              #    #           #    #    #    #    #
#                                              #     #     #    #    #    #    #
#############    ############################# #     #     #    #    #    #    #
#     #                                        #     #     #              #    #
#     #                                        #     #     ###########    #    #
#     #                                        #     #     #       #      #    #
#     #                                        #     #     #       #      #    #
#                                              #     #     #              #    #
#                                     *        #     #     #              #    #
################################################################################
