80 80
################################################################################
#      #    #     #                                                        #   #
#           #     #                                                            #
#           #     #                                                            #
#           #     #                                    #                       #
#           #     #                                    #              #        #
#    ###### #     #                                                   #####    #
#    #      #     ##########    ##################################### #        #
#    #      #     #       #                                           #        #
#    #      #     #       #                                           #        #
#           #     #                                                   #    #   #
#           #     #                                                   #    #   #
#           #     #                                                   #    #   #
#           #     #                                                   #    #   #
#    #      #     #                                                            #
#    #      #     #################################    #########################
#    #      #     #                                    #                       #
#    #      #     #                                    #                       #
#    #      #     #                                    #                       #
#    #      #     #                                    #                  #    #
#    #      #     #                                    #########    ##### #    #
#    #      #     ################    #################      #            #    #
#    #      #     #                                                       #    #
#    #      #     #                                                       #    #
#    #      #     #                                                       #    #
#    #      #     #                                                       ##   #
#    #      #     ###########    ######################################## #    #
#    #                                                     #        #     #    #
#    #                                                     #              #    #
#    #                                                     #              #    #
#    #                                                                    #    #
#    #      #     #                                                       #    #
#    #      #     ########    #############################               #    #
#    #      #     #                #                        ##    ####### #    #
#    #      #     #                #                       #              #    #
#    #      #     #                                        #              #    #
#    #      #     #                                        #              #    #
#    #      #                                                                  #
#    #      ################################################    ################
#    #      #                      #        #                #     #       #   #
#    #      #                      #        #                #     #       #   #
#    #      #                               #*               #     #       #   #
#    #      #                                     #    #     #     #       #   #
#    #      #                                     #    #           #       #   #
#    #      ######    ###################### ###    ## #           #       #   #
#    #      #                                          ##          #       #   #
#    #      #                               #          #           #       #   #
#    #      #                               #          #     #     #           #
#    #      #                               #          #     #     #           #
#    #      #                                          #     #     #           #
#    #      ######    ################################ #     #     #           #
#    #      #          #            #       #     #    ####    ### #       #   #
#    #      #          #            #       #     #    #     #     #       #   #
#    #      #          #            #             #    #     #     ##      #   #
#    #      #     #    #            #             #    #           #       #   #
#    #      #     #    #                               #           #       #   #
#    #      #     #    #                               #           #       #   #
#    #      #     #    #                    #          #           #       #   #
#    #      #     #    ##################   ####    ## #     #     #       #   #
#    #      #     #    #     #              #     #    #     #     #       #   #
#    #      #     #    #     #              #     #    #     ##    #       #   #
#    #      #     #    #                    #          ###   #     #       #   #
#    #      #     #    #                    #          #     #     #       #   #
#    #      #     #    #                               #     #     #       #   #
#    #      #     #     ###############    ########### #     #     #       #   #
#    #      #     #            #                 #     #     #     #           #
#    #      #     #            #                 #     #     #     #########   #
#    #      #     #            #                       #     #                 #
#    #      #     #    #                               #     #                 #
#    #   ## #     #    #                               #     #                 #
#    #      #     #    #                               #     #                 #
#    #      #     #    #        ###    ############### #     #     #           #
#    #      #     #    #       #                       #           #           #
#    #      #          #       #                       ##########    ###########
#    #      #   ###### #       #                       #                       #
#    #      #     #    ####    #          #            #                       #
#    #      #     #    #       #          #            #                       #
#    #      #          #       #          #            #                       #
#    #      #          #       #          #            #        #              #
################################################################################
