80 80
################################################################################
#               #      #            #       #    #    #    #     #             #
#                      #            #       #    #    #    #                   #
#                      #            #       #    #    #    #                   #
#                      #            #   ### #    #    #    #   ##     #####    #
#       #              #########    #       #    #    #    #               #   #
#       ##########     #    #       #       #    #    #    #     #         #   #
#       #       #      #    #               #    #    #    #     #         #   #
###     #       #      #                    #    #    #    #               #   #
#       #       #      #                    #    #    #    ##########      #   #
#       #       #      #                    #    #    #    #         #     #   #
#       #       #      #############    ### #    #    #    #         #     #   #
#       #       #      #        #    #      #    #    #    #         #     #   #
#       #       #      #        #    #      #    #    #    #         #     #   #
#       #       #      #        #    #      #    #    #    #######         #   #
#       #       #      #        #           #    #    #    #    #          #   #
#       #              #        #           #    #    #    #    #          #   #
#       #              #        #           #    #    #    #    #          #   #
#       #              #        #           #    #    #    #    #    #     #   #
#       #    ### ##    #        #    #      #    #    #    #    #    #     #   #
#       #       #      #        #    #      #    #    #    #         #     #   #
#       #       #      #        #    ###    #    #    #    #         #     #   #
#       #       #      #        #    #      #    #    #    #         #     #   #
#       #       #      #             #           #    #    #         #     #   #
#       #       #      #             #           #         #                   #
#       #       #      #             #           #         ###########    ######
#       #       #      #             #           #         #    #    #         #
#       #       #      #        #    #      #    #         #    #    #         #
#       #       #      #        #    #      #    #    #    #    #    #         #
#       #       #      #        #    #      #    #    #    #    #    #         #
#       #       #      #        #    #      #    #    #    #    #    #     #   #
#       #       #      #        #    #      #    #    #    #    #    #     #   #
#       #       #      #        #    #      #         #    #    #    #     #   #
#       #       #      #        #####    ## #         #    #    #    #     #   #
#       #       #      #        #    #      #     ##    ## #    #    #     #   #
#       #       #      #        #    #      #              #    #    #     #   #
#                      #        #    #      #    #         #    #    #     #   #
####    ############## #        #    #      #    #         #    #    ###   #   #
#          #           #        #    #      #    #         #         #     #   #
#          #           #        #    #      #####    ##### #         #     #   #
#          #           #        #    #      #                        #     #   #
#          #    #      ###      #    #      #                        #     #   #
#          #    #      #        #    #      #                   #    #     #   #
#     #    #    #      #        #    #      #                   #    #         #
#     #    #    #      #        #    #      #              #    #    #   #######
######     #    #      #        #    #      #       #      #    #    #     #   #
#     #    #    ##     #        #    #      ###     #      #    #    #     #   #
#     #    #    #      #        #    #      #       #      #    #    #     #   #
#     #    #    #      #        #    #      #       #      #    #    #     #   #
#     #    #    #      #        #    #      #       ####   #    #          #   #
#     #    #    #      #        #    #      #       #      #    #          # * #
#     #    #    #      #        #    #      #       #      #    #          #   #
#     #    #    #      #        #           #       #      #    #          #   #
#     #    #           #        #           #       #      #    #    #     #   #
#     #    #########   #                                   #    #    #     #   #
#     #    #      #    ###############    ################ #    #    #     #   #
#     #    #      #    #     #    #                        #####     #     #   #
#     #    #      #    #     #    #                        #    #    ##    #   #
#     #    #      #    #     #    #                        #    #    #     #   #
#     #    #      #    #          #                        #    #    #     #   #
#     #    #      #    #          #                        #    #    #     #   #
#     #    #      #    #                ################## #    #    #     #   #
#     #    #      #    #                    #              #    #    #         #
#          #      #    ##    #####          #              #    #    #         #
#          #      #    #                                   #    #    #         #
#          #   ## #    #          #                        #    #    #         #
#          #      #    #          #                        #    #    #     #   #
#     #    #      #    #          #                        #         #     #   #
#     #    #      #    #          #                        #         #     #   #
#     #    #      #    #          #                                            #
#     #    #           ###########    ##########################################
#     #    #           #                                                       #
#     #                #                                                       #
#     #                #                                                       #
#     #           #    #                             #                         #
#     #           #     ######    ################## #####    ##################
#     #    #      #                                  #                         #
#     #    #      #                                  #                         #
#     #    #      #                                  #                         #
################################################################################
