80 80
################################################################################
#                             #       #           #           #     #          #
#                             #                   #           #     #          #
#                             #                   #           #     #          #
#                             #              #    #######     #          #     #
#                      #      #              #    #    #      #          #     #
########################      #####   #      #    #    #      #          #     #
#        #     #        #     #       #      #    #    #      #                #
#        #     #        #     #       #####    ## #    #      #     #   ########
#        #     #        #     #       #      #    #    #      #     #    #     #
#        #     #        #     #       #      #    #    #      #     #    #     #
#   #    #     #####    #     #       #      #    #    #      #     #    #     #
#####          #        #     #       #           #    #      #     #    #     #
#              #        #     #       #           #    #      #     #    #     #
#              #        #     #       #           #    #      #     #    #     #
#              #        #     #       ##          #    #      #     #    #     #
#              #        #     #       #      #    #    #      #     #    #     #
###########    #        #     #       #      #    #    #      #     #    #     #
#    #         #        #             #      #    #    #      #     #    #     #
#    #         #        ###           #      #    #    #      #     #          #
#    #         #        #             #      #    #    #      #     #          #
#    #         #        #             #      #    #    #            #          #
#    #         #        #     #                   #    #            #          #
#    #         #        #     ###########    #### #    #   ###      #    #     #
#    #         #        #     #     #             #                 #    #     #
#    #         #        #     #     #             #           #     #    #     #
#    #         #        #     #                   #           #     #    #     #
#    #         #        #     #                   #           #     #    #     #
#     ###      #        #     #      ##    ###### #    #      #     #    #     #
#              #        #     #           #            #      #     #    #     #
#              #        #     #     #     #            #      #     #    #     #
#              #        #     #     #                  #      #     #    #     #
#    #         #        #     #     #                  #      #     #    #     #
#    #         #        #     #     #      ###    #    #      #     #    #     #
#    #         #        #     #     #             #    #      #     #    ##    #
#    #         #        #     #     #     #       #    #      #     #    #     #
#    #                  #     #     #     #       #    #      #     #    #     #
#    #                  #     #                               #     #    #     #
#    #                  #     ###########################     #                #
#    #                  #     #                               #############    #
#    #         #        #     #                               #                #
#    #         #        #     #                               #                #
#    #         #        #     #                               #                #
#    #         #        #     #                #              #           #    #
#    #         #              #                #              #           #    #
#    #         #              #                #              #           #    #
#    #         #              #                                                #
#                             #########################    #####################
###########    ######## #     #                                 #      #       #
#     #            #    #     #                                 #      #       #
#     #            #    #     #                                        #       #
#     #            #    #     #                                        #       #
#                  #    #     #                                        #       #
#           ##     #    #     #########    ########################### #       #
#          #       #    #     #      #     #                                   #
#          #       #    #     #      #                                         #
###    ### #       #    #     #      #                                         #
#          #       #    #     #      #          #                              #
#          #       #    #     #      #          ##########    ######## #       #
#          #       #    #     #      ####    ## #                      #       #
#                  #    #     #      #          #                      #       #
######    ######## #    #     #      #          #                      #       #
#    #             #    #     #      #          #                      #       #
#    #             #    #     #      #          #                      #       #
#    #             #    #     #      ###########    ################## #       #
#    #             #    #     #      #                       #    #    #       #
#    #             #    #     #      #                       #    #    #       #
#    ########      #    #     #      #                       #    #    #       #
#    #     #       #    #     #      #                       #         #       #
#                  #    #     #      ##    ################# #         #       #
#                  #    #     #    ##                                  #       #
#  ##              #    #     #                                        #       #
#                  #    #     #                                   #    ###    ##
#    #     #    ## #    #     #                      #            #### #       #
#    #     #            #     #      #########    ## #       #         #       #
#    #     #            #     #      #*     #        #   ### #         #       #
#    #     #            #     #      #      #        #       #         #       #
#    #     #            #     #      #               #       #         #       #
#    #     #       #    #     #      #               #       #    #    #       #
################################################################################
