80 80
################################################################################
#                            #       #         #                #              #
#                            #       #         #                #              #
#                            #       #         #                #              #
#   ######################## #       #    #    ########    #### #   ############
#    #                #      #       #    #    #                #              #
#    #                #      #       #    #    #                               #
#    #                #      #       #####     #                               #
#    #                #      #       #         #                               #
#    #######    ##    #              #         ###################    ##########
#    #    #      #    ####           #         #              #                #
#    #    #      #    #              #    #                   #                #
#    #    #      #    #              #    #                   #                #
#    #           #           #       #    #                   #                #
#    #           #           #       #    #                   #                #
#    #                       #       #    #    #                               #
#    ##    ###########       #       #    #    #                               #
##   #      #         #      #       #         #                               #
#    #      #         #      ##      ########    ###############################
#    #      #         #      #       #      #     #    #    #            #     #
#    #      #         #      #       #      #     #    #    #            #     #
#    #    ## #####    #      #       #      #     #    #    #            #     #
#                #    #      #       #            #    #    #            #     #
#                #    #      #       #            #    #    #            ###   #
#                     #      #       #            #    #         ####### #     #
#                     #      #       #                 #                       #
#    #                       #       #      #          #                       #
#    #####################   #       #      #          #                       #
#    #      #     #     #    #       #      #          #    #                  #
#    #      #     #          #       #      #     #    #    ##########    ######
#    #      #     #          #       ###    #     #    #    #         #        #
#    #      #     #          #       #      #     #    #    #         #        #
#    #      #     ###        #       #      #     #    #    #                  #
#    #      #     #     #    #       #      #     #    #    #              #   #
#    #      #     #     #    #       #            #    #    #              #   #
#    #      #     #     #    #       ##    ###### #    #    #              #   #
#    #      ###   #     #    #       #    #       #    #    #              #   #
#    #      #     #     #    #       #    #       #    #    #####    ##### #   #
#    #      #     #     #    #       #    #       #    #    #              #   #
#    #      #     #          #       #    #       #    #    #              #   #
#    #            ##    #### #       #    #    ## #    #    #              #   #
#    #            #     #    #       #    #       #    #                       #
#    #            #     #    #       #    #       #    ######    ###############
#    #            #          #            #       #    #     #     #     #     #
#    #      #     #          #            #       #    #     #     #     #     #
#    #      #     #          #            #       #    #     #     #     #     #
#    #      #     #          #                    #    #     #     #     #     #
#    #      #           #    #       #            #    #     #   ##      #     #
#    #      #           #    #       #            #    #     #           #     #
#    #      #           #    #       #            #    #     #           ####  #
#    #      #           #    #       #    #       #    #     #           #     #
#    #      #     #     #    #       #    #       #    #           #    ##     #
#    #####    ### #     #    #       #    #       #    #           #           #
#    #    #       #     #    #       #                 #           #           #
#    #    #       #     #    #       #######    ###### #           #           #
#    #    #       #     #    #       #     #           #           #           #
#    #    #       #     #    #       #     #           #########   #   #########
#    #    #    ## #     #    #       #     #           #    #      #       #   #
#    #            #     #    #       #     #           #    #      #       #   #
#    #            #     #    #       #     #     #     #    #      #       #  *#
#    #            #     #    #       #     #     ###   #    #      #       #   #
#                                    #     #     #     #    #      #       #   #
#######    ######################### #     #     #     #    #      #           #
#              #    #    #           #     #     #     #    ####   #           #
#              #    #    #           #     #     #     #    #      #           #
#              #    #    #           #     #     #     #    #      #           #
#                   #                #     #     #     #    #      #       #   #
#                   #                #     #           #    #      #####   #   #
#                   #                ###   ########    #           #       #   #
#                   #                #     #      #    #           #       #   #
##########    ##    #############    #     #      #    #           #       #   #
#              #    #          #     #     #      #    #           #       #   #
#              #    #          #     #            #    #    #      #       #   #
#              #                     #      ###   #    #    #      #       #   #
#              #                     #            #    #    #      #       #   #
############    #### ######          #                 #    #      #       #   #
#                                    #     #                #      #       #   #
#                   #          #     #     #                #      #       #   #
#                   #          #     #     #                #      #       #   #
################################################################################
