80 80
################################################################################
#                 #                                                 #      #   #
#                 #                                                 #      #   #
#                 #                                                 #      #   #
#                 #                                                 #          #
#                                                                   #          #
#                                                                   #          #
#                                                                   #          #
######################################    ######################### #      #   #
#    #      #            #                       #       #     #    #      #   #
#           #            #                       #       #     #    #      #   #
#           #            #                               #     #    #      #   #
#           #            #                  #            #     #    #      #   #
#           #       #    #    ############# #            #     #    #      #   #
#  ######## #       #    #          #       #            #     #    #      #   #
#   #       ######    ## #          #       #            #     #    #      #   #
#   #       #       #    #          #       #   ######## #     #    #      #   #
#   #       #       #    #          #       #       #    #     #    #      #   #
#   #       #       #    #####      ###     #       #    #     #    #      #   #
#   #       #       #    #          #       #            #     #    #      #   #
#   #####   #       #    #                  #            #     #    #      #   #
#   #           ####     #                  #            #     #    #      #   #
#   #                    #                               #     #    #      #   #
#   #                    ########    ################### ###   #    #      #   #
#                        #     #           #       #     #     #    #      #   #
#           #       #    #     #                   #     #     #    #      #   #
#           #       #    #                         #     #     #    #      #   #
#           #       #    #                         #     #          #      #   #
#           #       #    #                  ###    #     #          #      #   #
#           #            ###########    ## #       #     #          #      #   #
#########    ########### #                 #       #     ########   #      #   #
#       #          #     #                 #       #     #     #    #      #   #
#       #          #     #                 #                   #    #      #   #
#       #          #     #                 #                   #    #      #   #
#                  #     ##################    ####            #    #          #
#                  #     #       #         #                   #    ###    #####
#                  #     #       #         #       #     #     #    #          #
#                  #     #                 #       #     #     #    #          #
#                  #     #                 #       #     #     #    #          #
##############     ##    #        ####     #       #     #     #    #          #
#       #    #     #     ###               #       ###   #     #    #      #   #
#       #          #     #       #                 #     #     #    #      #   #
#       #          #     #       #                 #     #     #    #      #   #
#       #          #     #       #                 #     #     #    #      #   #
#       #          #     #     * #                 #     #     #    #      #   #
#       #          #     ########    ##### #       #     #     #           #   #
#       #          #                       #       #     #     #           #   #
#####    ######    #                       #   ### #     #     #           #   #
#             #                            #       #     #     #           #   #
#                                          #       #     #     #    #      #   #
#                        #                 #       #     #     #    #      #   #
#                        #                 #       #     #     #    #      #   #
#                                                        #     #    #      #   #
###############################    ##################### #     #    #      #   #
#        #                   #    #                      #     #    #      #   #
#        #                   #    #                      #     #    #      #   #
#        #                   #                           #     #    #      #   #
#                            #                           #     #    #      #   #
#                            #                           #     #    #      #   #
#                            ##########    ############# #     #    #      #   #
#                            #                 #         #     #    #      #   #
#    ####################### #                 #         #     #    #      #   #
#              #    #        #                 #         #     #    #      #   #
#                   #        #                 #    #    #     #    #      #   #
#                   #        #           #     #    #    #     #    ###    #   #
#                   #        #           #     #    #    #     #    #      #   #
####      #         #    ### #                 #    #    #     #    #      #   #
#   #     #######   #        #    ############ #    #    #     #    #      #   #
#   #     #    #             #    #      #     #    #    #     #    #      #   #
#   #     #    #             #           #          #    #     #    #      #   #
#   #     #    #             #           #          #    #     #    #      #   #
#   #     #                              #               #     #    #      #   #
#   ###   #                              ##        ##### #     #    #      #   #
#   #     #                        ######      #         #     #    #      #   #
#   #     ######    #########     #            #         ###   #    #      #   #
#         #          #       #    #            #         #     #    #      #   #
#         #                  #                 #    #    #     #    #      #   #
#         #                  #           #     #    #    #          #      #   #
#         #                  #           #     #    #    #          #      #   #
################################################################################
