80 80
################################################################################
#     #                                                                        #
#     #                                                                        #
#     #                                                                        #
#     #     ##################    ##############################################
#     #    #      #                                                            #
#     #    #      #                                                            #
#     #    #      #                                                            #
#     #    #      #                      #                                     #
#     #    #      ##################     ######    #############################
#     #    #      #                      #                                     #
#     #    #      #                      #                                     #
#     #    #      #                      #                                     #
#     #    #      #                                                            #
#     #    #      ##########    ################################################
#     #    #      #        #                                         #         #
#     #    #      #        #                                         #         #
#     #    #      #        #                                         #         #
#     #    #      #        #                                         #         #
#     #    #      #        #                                                   #
#     #    #      #        #                                                   #
#     #    #      #        #                                                   #
#     #    #      #        ############################################    #####
#     #    #      #        #    #        #      #                          #   #
#          #      ######   #    #        #      #                          #   #
#          #      #        #    #        #      #                              #
#          #               #    #        #      #                              #
#    ##### #               #             #      #                              #
#    #     #               #             #      #####    #######################
#    #     #               #             #      #              #               #
#    #     #      #        #####    #### #      #              #               #
#    #     #      #        #       #     #      #              #               #
#    #     #      #        #       #     #      #              #               #
#    #     #      #        #       #     #      #                              #
#    #     #      #                #     #                                     #
#    #     #      #                #     #                                     #
#    #     #      #                #     #                                     #
#          #      #                #     ####    ###############################
#          #      #        #       #     #        #     #      #          #    #
#          #      #        #       #     #        #     #      #          #    #
#          #      #        #       #     #        #     #                 #    #
#    #     #      #        #             #        #     #                      #
#    #     #      #        #             #        #     #                      #
#    #     #      #        #             #        #     #                      #
#    #     #      #        #             #        #     #                      #
#    #     #      #        #       #     #        #   ## #########    ### #    #
#    #     #      #        #       #     #        #                       #    #
#    #     #      #        #       #     #        #                       #    #
#    #     #      #        #       #     #        #                       #    #
#    #     #      #        ####    #     #        #                       #    #
#    #     #      #        #       #     #        #    ################## #    #
#    #     #      #        #       #     #        #                       #    #
#    #     #      #        #       #     #        #                       #    #
#    #     #      #        #*      #     #        #                       #    #
#    #     #      #        #       #     #        #        #      #       #    #
#    #     #      #        #       #     #        #        #      #       #    #
#    #     #      #        #       #     #        #               #       ###  #
#    #     #      #        #       #     #        ##    ######### #       #    #
#    #     #      #        #       #     #        #               #       #    #
#    #     #      #        #       #              #               #    ## #    #
#    #     #      #        #       #              #               #       #    #
#    #     #      #        #       #              #         #     #       #    #
#    #     #      #        #       #              #         #     #       #    #
#    #     #      #        #       #     #        #         #     #       #    #
#    #     #      #        #       #     #        #                            #
#    #     #      #        #       #     #        ####    ######################
#    #     #      #        #       #     #        #            #               #
#    #     #      #        #       #     #        #                            #
#    #     #      #        #       #     #        #                            #
#    #     #      #        #       #     #                                     #
#    #     #      #        #       #     #                              #      #
#    #     #      #        #       #     #         ##########    ###### #      #
#    #     #      #        #       #     #               #              ##    ##
#    #     #      #        #       #     #        #      #              #      #
#    #     #      #        #       #     #####    #                     #      #
#    #     #      #        #       #     #        #                     #      #
#    #     #      #        #       #     #        #                     #      #
#    #     #      #        #       #     #        #                     #      #
#    #     #      #        #       #     #        #      #              #      #
################################################################################
