80 80
################################################################################
#                          #    #     #        #     #          #     #        #
#                               #     #        #     #          #     #        #
#                               #     #        #     #          #     #        #
#                               #              #     #                #   ######
#                               #              #     #                         #
#                               #              #     #                         #
####    ####################### #              #     ##############            #
#                   #    #      #     #        #     #                         #
#                   #    #      #     #        #     #                #    #   #
#                   #    #      #     #        #     #                #    #   #
#                   #    #      #     #        #     #                #    #   #
#                   #    #      ##    #        #     #                #    #   #
##############      #    #      #     #   #### #     #                     #   #
#   #         #     #    #      #     #        #     ####################    ###
#   #         #     #    #      #     #        #     #    #       #        #   #
#   #               #    #      #     #              #    #       #        #   #
#   #               #    #      #     #              #    #       #        #   #
#   #               #    ####   #     #              #    #       #        #   #
#   #######         #    #      #     #              #    #       #        #   #
#   #    #    #     #    #      #     #        #     #    #       #        #   #
#   #         #     #    #            #        #     #    #       #        #   #
#   #         #     #    #            #        #     #    #       #        #   #
#   #         #     #    #            #        #     #    #       #        #   #
#   #         #     #    #            #        #     #            #        #   #
#   #    #    #     #    #      #     #        #     #            #        #   #
#   #    #    #          #      #     #        #     #            #        #   #
#   #    #    #          #      #     #        #     #            #        #   #
#   #    #    #          # *    #     #        #     #    #       #        #   #
#   #    #    #          #      #     #        #     #    #       #        #   #
#   #    #    #     #           #     #        #     #    #       #        #   #
#   #    #    #     #           #     #        #     #    #       #        #   #
#   #    #    #     #           #     #        #     #    #       #        #   #
#   #    #    #     #           #     #        #     #    #       #        #   #
#   #         #     #########   #     #        #     #    #       #        #   #
#   ##########      #      #    #     #        #     #    #       #        #   #
#   #    #    #     #      #    #     #        #     #    #       #        #   #
#        #    #     #      #    #     #        #     #    #       #        #   #
#        #    #     #      #    #     #        #     #    #       #        #   #
#        #    #     #      #    #     #        #     #    #       #        #   #
#        #    #     #      #    #              #     #    #       #        #   #
#   #         #     #      #    ########    ## #     #    #       #        #   #
#   #         #     #      #    #              #     #    #       #        #   #
#   #         #     #      #    #              #     #    #       #   #### #   #
#   #         #     #      #    #              #     #    #       #        #   #
#   #    #    #     #      #    #                    #    ###     #        #   #
#   #    #          #      #    ##################   #    #       #        #   #
#   #    #          #           #                    #    #                #   #
#   #    #          #           #                    #    #                #   #
#   #    ###    ### #           #                    #    #                #   #
#   #    #          ####        #                    #    #                    #
#   #    #          #      #    #############   #    #    #                    #
#   #    #          #      #    #               #    #    ######    #######    #
#   #    #          #      #    #               #    #    #       #            #
#   #    #          #      #    #               #    #    #       #        #   #
#        #                                           #    #       #        #   #
#######    ######################################### #    #                #   #
#                     #         #              #     #    #                #   #
#                     #         #              #     #    #                #   #
#                               #              #          #                #   #
#          #                    #              #          #                #   #
#   ###### #                    #              #          #                #   #
#     #    ################     ###    ####### #      ##    ############## #   #
#     #    #                    #     #        #     #    #    #           #   #
#          #                    #     #        #     #    #    #           #   #
#          #                    #     #        #     #    #    #           #   #
#                               #              #     #    #    #           #   #
###    ######################## #              #     #    #    #      #    #   #
#    #                          #      ###     #     #         #      #    #   #
#    #                              ##         #     #         #      #    #   #
#    #                                #        #     #         #      #    #   #
#    #                                #              #                #    #   #
#    #    ######################      #              #                #    #   #
#                         #     #     #              #                #    #   #
#                         #     #                    #######          #    #   #
#                         #     #############    ### #    #    ####    ### #   #
#                               #                    #    #    #           #   #
#    #                          #                    #         #           #   #
#    #                          #                    #         #           #   #
################################################################################
