80 80
################################################################################
#                             #         #    #        #                        #
#                             #         #    #        #                        #
#                             #              #        #                #       #
#                             #              #                         #       #
#     #                       #              #                         #       #
#     #                       #              #                         #       #
#     #                       #    ######### #         ##############    #######
####    ##################### #    #    #    #        #      #      #     #    #
#           #      #          #    #    #    #        #      #      #     #    #
#           #      #          #    #    #    #        #             #     #    #
#           #      #          #    #    #             #             #     #    #
#           #                 #    #    #             #             ###   #    #
#           #           #     #    #    #             #             #     #    #
#     #     #           #     #         #     #####   #             #          #
#     #     #           #     #         #    #        #             #          #
######      #      #    #     #         #    #        #    ######## #          #
#     #     #      #    ##    #####     #    #        #        #    #          #
#     #     ####    ### #     #    #    #    #        #        #    #     #    #
#     #     #      #    #     #    #    #    #        #        #          ######
#     #            #    #     #    #    #    #        #        #           #   #
#     #            #    #     #    #    #    #        #   #####                #
#     #            #    #     #    #    #    #        #                        #
#     #            #    #     #    #    #    #        #             #          #
#     #     #      #    #     #    #    #    #        #             #          #
#     #     #      #    #     #    #    #    #        #             #          #
#     #     #      #    #     #    #    #    #                                 #
#     #     #      #    #     #    #    #    #########################    ######
#     #     #      #    #     #    #    #    #       #      #     #        #   #
#     #     #      #    #     #    #    #    #       #      #     #        #   #
#     #     #      #    #     #    #         #       #      #     #        #   #
#     #     #      #    #     #    #         #       #      #     #            #
#     #     #      #    #     #              #       ####         #            #
#     #     #      #    #     #              #       #            #            #
#     #     #      #    #     #         #    #       #            #            #
#     #     #   ## #    #     #         #    #       #            #            #
#     #     #      #    #     #    #    #    #       #      #     ###    #######
#     #     #           #     #    #    #    #       #      #     #      #     #
#     #     #           #     #    #    #    #       #      #     #      #     #
#     #     #           #     #    #    #    #       #      #     #      #     #
#     #     #           #          #    #    #       #      #     #      #     #
#     #     #      #    #          #    #    ####    #      #     #      #     #
#     #     #      #    #          #    #    #       #      #     #      #     #
#     #     #      #    #          #    #    #       #      #     #      #     #
#     #     #      #    #     #    #    #    #       #      #     #      #     #
#     #     #      #    #     #    #    #    #       #            #      #     #
#     #     #      #    #     #    #    #    #       #   ######## #      ####  #
#     #     #      #    #     #    #    #    #       #       #    #      #     #
#     #     #      #    #     #    #    #    #       #                   #     #
#     #     #      #    #     #    #    #    #                           #     #
#     #     #      #    #     #    #    #    #                           #     #
#     #     #      #    #     #    #    #    #                           #     #
#     #     #      #    #     #    #    #    #               #    ##     #     #
#     #     #                 #    #    #    #       #       #    #      #     #
#     #     ##    ########### #    #    #    #       ####    #    #      #     #
#     #     #    #    #       #    #    #    #       #       #    #      #     #
#     #     #    #    #       #    #    #    #       #       #    #      #     #
#     #     #    #    #       #    #    #    #       #       #    #      #     #
#     #     #    #    #       #    #    #    #       #       #    #      #     #
#     #     #    #    #       #    #    #    #                    #      #     #
#     #     #    #    #       #    #    #    ####    ############ #      #     #
#     #     #    #    #       #    #    #    #           #        #      #     #
#     #     #    #    #       #    #    #    #           #        #      #     #
#     #     #    #    #       #    #    #    #           #        #            #
#     #     #    #    #       #    #    #    #           #        #            #
#     #     #    #    #       #    #    #    #                    #            #
#     #     #    #    #    ## #    #    #    #                    #            #
#     #     #                 #                                                #
#     #     #                 #############################    #################
#     #     #                 #                                        #       #
#     #     #                 #                                        #   *   #
#     #     #    #    #       #                                        #       #
#     #     #    #    #       #                                        #       #
#     #     ###    ## #       #                                        #       #
#           #    #    #       #                                        #       #
#           #    #    #       ###############    ##################### #    ####
#           #    #    #       #                                                #
#           #         #       #                                                #
#     #     #         #       #                                                #
################################################################################
