80 80
################################################################################
#                              #                 #      #          #       #   #
#                              #                 #      #          #       #   #
#       #                      #                 #                         #   #
#       #                      #                 #                         #   #
####    #                      ###############   #                         #   #
#       #######    ########### #    #     #      #                         #   #
#       #                      #    #            #                 #       #   #
#       #                      #    #            #############     #       #   #
#       #                      #    #            #     #    #      #       #   #
#                              #    #            #     #    #      #       #   #
##########################     #    #    ##      #     #    #      #       #   #
#        #     #    #          #    #     #      #     #    #      #       #   #
#                              #          #      #     #    #      #       #   #
#                              #          ###    #     #    #      #       #   #
#   #                          #          #      #     #    #      #       #   #
#   #                          #          #            #    #      #       #   #
####    ##     #    #          #######    #            #    #      #       #   #
#        #     #    #          #    #     #            #    #      #       #   #
#        #     #    #          #    #     #            #    #      #       #   #
#        #     ###    ######## #    #     #      #     #           #       #   #
#        #     #          #    #    #     #      #     #           #       #   #
#              #          #    #    #     #      #                 #       #   #
############   #          #         ##    #      #                 #       #   #
#              #          #         #     #      #          #      #       #   #
#              #                    #     #      #          #      #       #   #
#              #                          #      #     #    #      #       #   #
#              #               #          #      #     #    #      #       #   #
#                              #                 #     #    #      #       #   #
#############################    ############### #          #   ## #           #
#       #            #           #               ########   #      #           #
#       #            #           #               #    #     #      #           #
#                    #                           #    #     #      #           #
#                    #                           #    #     #      #       #   #
#             #      #                           #    #     #      ##      #   #
#             #   ## ############    ########### #    #     #      #       #   #
#       #     #      #      #          #    #    #    #     #      #       #   #
#       #     #      #                 #    #    #    #     #      #       #   #
####    #     #      #                 #         #    #     #      #       #   #
#       #            #                 #         #    #     #      #       #   #
#       #    ####### #                 #         #    #     #      #       #   #
#       #            #                 #         #    #     #      #       #   #
#       #            #############     #    #    #    #     #      #       #   #
#       #            #           #     #    #    #    #     #      #       #   #
#                    #           #     #    #    #    #     #      #       #   #
##############    ## #           #     #         #    #     #      #       #   #
#    #      #        #           #     #######   #    #     #      #       #   #
#                    #           #     #    #    #    #    *#      #       #   #
#                    ####    ####      #    #    #    #     #      #       #   #
#                    #     #           #    #    #    #     #      #       #   #
#                    #     #           #    #    #    #     #      #       #   #
#           #        #     #           #         #     ##   #      #       #   #
#  ######## ###      #     #     #     #         #          #      #       #   #
#   #       #        #           #               #          #      #       #   #
#           #        #           #               #          #      #       #   #
#           #                    #          #    #    #     #      #       #   #
#           #                    #          #    #    #     #      #       #   #
#                                                                  #       #   #
######    ######################################################## #       #   #
#                                                         #        #       #   #
#                                                         #        #       #   #
#                                                         #        #       #   #
#                                                         #        #       #   #
#                                         #               #        #       #   #
#                                         #               #        #       #   #
#                                         #               #        #       #   #
#                                                         #        #       #   #
#############################    ######################## #        #       #   #
#   #    #                                                ######   #       #   #
#   #                                                     #        #           #
#                                                         #        ##########  #
#                      #                                  #        #    #      #
#                      #                                  #        #    #      #
#    ### #                                                #        #    #      #
#   #    #####################################    ####### #        #    #      #
#   #    #                                                #        #           #
#   #    #                                                         #           #
#        #                                                         #           #
#        #                                                         #           #
################################################################################
