80 80
################################################################################
#     #      #        #       #         #    #             #               #   #
#     #      #        #       #         #    #             #               #   #
#     #      #        #                 #    #             #       #       #   #
#     #      #                          #          #       #       #       #   #
#            #                          #          #       #       ####        #
#            #         ####    ######## #          #       #       #           #
#            #             #                 ##### #       #   ### #           #
#            #        #    #                 #     #       #       #           #
#     #      #        #                      #     #       #       #       #   #
#     #      #        #                      #     #       #       #       #   #
#     #      #        #     #######    ##          #       #       #       #   #
#     #      #        #                 #          #       #               #   #
#     #      #        #    #            #          #       ####    ####### #   #
#     #      #        #    #            #          #       #               #   #
#     #      ####     #                            #       #               #   #
#     #      #        ######################    ## #####   #               #   #
#     #      #        #                            #       #                   #
#     #      #        #                            #       ############    #####
#     #      #        #                            #       #               #   #
#     #      #        #          #                 #       #               #   #
#     #      #        #          #########    #### #       #               #   #
#     #      #        #          #           #     #       #               #   #
#     #      #        ####    ## #           #     #       #               #   #
#     #      #        #          #                 #       ##    ######### #   #
#     #      #        #          #                 #            #          #   #
#     #      #        #          #                 #            #              #
#     #      #                                     #                           #
#     #      #####    ############################ #                           #
#     #      #                 #        #    #     #       #                   #
#     #      #                 #        #    #     #       #                   #
#     #      #                 #        #    #     #                           #
#     #      #                 #        #    #     #############    ############
#     #   ## #                 #        #    #     #     #                     #
#     #      #######    ###### #        #    #     #     #       *             #
#     #      #                 #   #### #          #     #                     #
#     #      #                 #        #          #     #                     #
#     #      #                                     #     #    ##################
#     #      #                                     #     #     #       #       #
#     #      #                               #     #     #     #       #       #
#     #      ##    #####################     #     #     #     #       #       #
#     #      #      #      #            #    #     #     #     #       #       #
#     #      #      #      #            #    #     #     #     #       #       #
#     #      #      #                   #    #     #     #     #       #       #
#            #      #                   #    #     #     #             #       #
#######      #      #                   #    #     #     #             #       #
#      #     #      #                   #    #     #     #              ###    #
#      #            ##############      #    ##    #     #                     #
#      #            #      #       #    #    #     #     #     #               #
#      #            #      #       #    #    #     #     #     #               #
#      #            #      #       #    #    #     #           #       #       #
#      #     #      #      #       #    #    #     #           #       #       #
#      #     #      #      #       #    #    #     #           #       #       #
#      #     #      #      #       #    #    #     #           #       #       #
#      #     #      #      ###     #    #    #     #     #     #       #       #
#            #      #      #       #    #    #     #     #     #       #       #
#            #      #      #       #    #          #     #     #       #       #
#            #      #      #       #    ########   #     #     ##      #       #
#            #      #      #       #    #    #     #     #     #       #       #
#      #     #      ##     #            #    #     #     #     #       #       #
#      #     #      #      #            #    #     #     #     #       #       #
#      #     #             #            #          #     #     #       #       #
#      #     #             #            #          #     #     ######    #######
#      #     #             ####    #### #          #     #     #        #      #
####   #     ##            #            #          #     #     #        #      #
#      #     #      #      #            #    ###   #     #     #               #
#      #     #      #                   #    #     #     #     #               #
#      #     #      #             #     #    #     #     #     ####          ###
#      #     #      #             ##    #    #     #     #     #               #
#      #     #      #             #     #    #     #     #     #        #      #
#      #     #      #      #      #     #    #     #     #     #        #      #
#      #     #      #      #      #     #    #     #     #     #        #      #
#      #     #                               #                                 #
#      #     ##############################    #################################
#      #     #                                                                 #
#      #     #                                                                 #
#      #     #                                                                 #
#      #     #                                                                 #
#      #     #                                            #                    #
################################################################################
