80 80
################################################################################
#   #    #                                                          #      #   #
#   #    #                                                          #      #   #
#   #    #    #                                                     #          #
#   #    #    ##################    ############################### #          #
#   #    #    #                               #                     #    ##    #
#   #    #    #                               #                     #          #
#   #    #    #                                                     #      #   #
#   #    #    #                                                     #      #   #
#   #    #    #######################    ##### ##############    ## #          #
#   #    #    #                                    #                      ######
#   #    #    #                               #                                #
#   #    #    #                               #                                #
#   #    #    #                               #                                #
#   #    #    #                               #                                #
#   #    #    #############################    #################################
#   #    #    #               #     #              #            #              #
#   #    #    #               #     #              #            #              #
#   #    #    #               #     #              #                           #
#   #    #    #          #    #     #              #                           #
#   #    #    #          #    #     #              #                           #
#   #    #    #########    ## #          ######### #                           #
#   #    #    #               #            #       #                           #
#   #    #    #               #            #       ########################    #
#   #    #    #                            #       #     #       #      #      #
#   #    #    #                     #      #       #     #       #      #      #
#   #    #    #                     ###    ####    #     #       #      #      #
#   #    #    ##    ############### #      #       #     #       #      #      #
#   #    #    #                     #      #       #     #       #      #      #
#   #    #    #                     #      #       #     #       #      #      #
#   #    #    #                     #                    #       #      #      #
#   #    #    #                     #                    #       #             #
#   #    #    #                     #                    #       #             #
#   #    #    ######################    ###########      #       #             #
#   #    #    #    #      #        #    #     #    #     #       #             #
#   #    #    #    #      #        #    #     #    #     #       #      #      #
#   #    #    #           #        #    #     #    #     #       #      #      #
#   #    #    #           #        #    #     #    #      ##     #      #      #
#   #    #    #           #             #     #    #             #      #      #
#   #         #           #             #     #    #             #      #      #
#   #         #    #      #             #     #    #             #      #      #
#   #         #    #      #             #     #    #     #       #      #      #
#   #         #    #      #    ### #    #     #    #     #       #      #      #
#        #    #    #      #        #    #     #    #     #       #      #      #
#        #    #    #      #        #    #     #    #     #       #      #      #
#        #    #    #      #        #    #     #    #     #              #      #
#        #    #    #      #        #    #     #    #     #              #      #
#   #    #    #    #      #        #    #     #    #     #              #      #
#   #    #    #    #      #        #    #     #    #                    #      #
#   #    #    #    #      #        #    #     #    #######    ## #      #      #
#   #    #    #    #      #        #    #          #     #       #      #      #
#   #    #    #    #      #        #    #          #     #       #      #      #
#        #    #    #      #             #          #             #      #      #
#  ##### #    #    #      ##########    #    ##### #             #      ###    #
#   #    #    #    #      #        #    #     #    #             #      #      #
#   #    #    #    #      #        #    #     #    #             #      #      #
#   #    #    #    #      #        #    #     #    #     #       #      #      #
#        #    #    #      #        #    #     #    #     #       #      #      #
#        #    #    #   ## #        #    #     #    #     #       #      #      #
#             #    #      #        #    #     #    #     #       #      #      #
###########   #    #      #             #     #    #     #       #      #      #
#      #      #    #      #             #     #    #     #       #   ## #      #
#      #      #    #      #             #     #    #     #       #      #      #
#      #      #    #      #             #     #    #     #       #      #      #
#      #      #    #      ####    ##    #     #    #     #       #      #      #
#      #      #    #               #    #     #    #     #       #      #      #
#      #      #    #               #    #     #    #     #       #####    ######
#             #    #               #    #     #    #     #       #       #     #
#             #    #               #    #     #    #     #       #       #     #
#             #    #      #        #    #     #    #     #   ### #       #     #
#             ##    ##### #        #    #     #    #     #       #       #     #
#      #      #           #        #          #    #     #       ##      #     #
#      #      #           #        #          #    #     #       #       #     #
#      #      #           #        #               #     #       #       #   ###
#      #      #                                    ##    #       #       #     #
#      ##     #######################   #          #     #       #       #     #
#      #      #                         #          #     #       #             #
#      #      #                         #     #    #     #       #             #
#      #      #                        *#     #    #     #       #             #
################################################################################
