80 80
################################################################################
#                                           #       #                  #       #
#                                           #       #                  #       #
#                                           #       #                  #       #
#                                           #             ###    ##### #       #
#   ####################################### #             #     #      ##    ###
#                #                     #    #             #     #              #
#                #                     #    #####         #                    #
#                #                     #    #       #     #                    #
#      #         #                     #    #       #     #                    #
#      #         ##    ############### #    #       #     ######    ############
#      #         #       #    #        #    #       #     #                #   #
#      #         #       #    #        #    #       #     #                #   #
#                #       #    #        #    #       #     #                #   #
###    ######### #       #    #        #    #       #     #       #            #
#        #       #       #    #        #    ########      #       #            #
#        #       #       #    #        #    #     #       #       #            #
#        #       #       #    #        #    #             #       #            #
#        #       ####    #             #    #             #       #        #   #
#        #       #                     #    #             #####    ####### #   #
#        #       #                     #    #             #                #   #
#                #                     #    #     #       #                #   #
#                #            #        #    #     #       #                #   #
#                #       #    #        #    #                                  #
#                #       #    #        #    ###############    #################
#        #       #       #    #        #    #    #     #     #     #           #
#        #       #       #    #        #    #    #     #     #     #           #
#        #       #       #    #        #    #    #     #     #                 #
#        #       #       #    #        #    #    #     #     #                 #
#        #       #       #    ######   #    #          #     #                 #
#        #       #       #    #        #    #          #     #                 #
#        #       #       #    #        #    #          #     ##    #############
#        #       #       #    #        #    ########   #     #    #      #     #
#        #       #       #    #        #    #     #    #     #    #      #     #
#        #       #       #    #        #    #     #    #     #    #            #
#        #       #       #    #        #    #     #    #          #            #
#        #       #       #    #        #    #     #    #                       #
#        #       #       #    #        #    #     #    #                       #
#        #       #       #    #        #    #     #    #           #######    ##
#    ### #       #       #    #        #    #     #    #     #         #       #
#        #       ######    ## #        #    #     #    #     #    #    #       #
#        #       #    #       #        #    #     #    #     #    #    #       #
#        #       #    #       #        #    #     #    #     #    #            #
#        #       #    #       #        #    #     #    #     #    #            #
#        #       #    #       #        #    #     #    #     #                 #
#        #       #    #       #        #    #     #     ##    ##################
#        ####    #    #       #        #    #                #             #   #
#        #       #    #       #        #    #                #             #   #
#        #       #    #       #             #                              #   #
#        #       #    #       #             #          #                   #   #
#        #       #    #       #             #     #    #      #######      #   #
#        #       #    #       #             #     #    #             #     #   #
#        #       #    #####   #        #    #     #    #    ##       #     #   #
#        #       #    #       #        #    #     #    #     #       #     #   #
#        #       #    #       #        #    #     #    #     #             #   #
#        #       #    #       #        #    #     #    #     #             #   #
#        #       #    #       #        #    #     #    #     #             #   #
#        #       #    #       #        #    #     #    ###    ############ #   #
#        #       #    #       #        #    #     #    #    #              #   #
#        #       #    #       #        #    #     #    #    #              #   #
#        #            #       #        #    #     #    #    #              #   #
#        #                    #        #    #     #    #    #              #   #
#        #                    #        #    #     #    #    #              #   #
#        #                    #        #    #     #    #    #              #   #
#        #       #            #        #    #     #    #    #########      #   #
#        #       #            #        #    #     #    #    #              #   #
#                             #        #    #     #    #    #              #   #
############################    ###### #    #     #    #    #              #   #
#            #                         #    #     #    #    #                  #
#            #                         #    #     #    #    #       #          #
#                                      #    #     #    #    #       #          #
#                                      #    #     #    #    #       ###        #
#####    #### #########    ########### #          #    #    #       #      #   #
#                                      #          #    #     ####   #      #   #
#            #                         #          #    #            #      #   #
#            #                         #          #    #            #      #   #
#    #       #           #             #    #     #    #            #      #   #
#    #       #           #           * #    #     #    #    #       #      #   #
#    #       #           #             #    #     #    #    #       #      #   #
################################################################################
