80 80
################################################################################
#                                      #                              #    #   #
#                                      #                              #    #   #
#                                      #                              #    #   #
#                         #            #                              #    #   #
#                         #            #########    ########## #   ## #    #   #
#                                      #                       #      #    #   #
########    ########################## #                       #      #    #   #
#    #         #       #     #                                 #      #    #   #
#    #         #       #     #                                        #    #   #
#    #         #       #     #          ###############    ########## #    #   #
#    #         #       #     #                 #                      #        #
#    #         #       ##    #         #       #                      #        #
#    #         #       #     #         #       #                      #        #
#    #         #       #     #         #       #                      #   ######
#    #         #       #     #         #       #                      #        #
#    #         #       #     #         ###      ##########    ####### #        #
#    #         #       #     #         #            #                 #        #
#    #         #       #               #                                       #
#    #         #       #               #                                   #   #
#    #         #                       #       #                           #   #
#    #         #                       #       #                           #   #
#    #         #             #         #       #                               #
#    #         #             #         #####    ################################
#    #         #       #     ######    #                #          #       #   #
#    ####      #       #     #         #                #          #       #   #
#              #       #     #         #                #          #       #   #
#              #       #     #         #                #          #       #   #
#              #       #     #         #####    ####### #####      #    ###    #
#              #       #     #         #          #     #    #     #           #
##   #         ##      #     #         #          #     #    #     #           #
#    #         #       #     #         #          #     #    #     #           #
#    #         #       ####    ####### #          #     #    #     #       #   #
#    #         #       #               #####      #     #    #     #       #   #
#    #         #       #               #          #     #    #     #           #
#    #         #       #               #          #     #    #     #########   #
#    #         #       #      #        #                #    #     #      #    #
#    #         #              #        #                #    #     #      #    #
#    #         #############    ###### #    #           #    #     #      #    #
#    #         #     #                 #    #   *       #    #     #      #    #
#    #         #     #                 #    #     #     #    #     #      #    #
#    #         #     #                 #    #     #     #    #     #      #    #
#    #         #     #                 #    #     #     #    #     #      #    #
#    #         #     #     ###    #### #    #     #     #    #     #           #
#    #         #     ###   #           #    #     #     #    #     #           #
#    #         #     #     #           #    #     #     #    #     #           #
#    #         ##    #     #           #    #     #     #    #     #    ##     #
#    #         #     #     #           #    #     #     #    #            #    #
#    #         #     #                 #    #     #     #    #            #    #
#    #         #     #   ############# #    #     #     #    #            #    #
#####    ##### #     #       #    #    #    #     #     #    #            #    #
#       #      #     #       #    #    #    #     #     #    #     #      #    #
#       #      #     #       #    #    #    #     #     #    #     #      #    #
#       #      #     #       #    #    #    #     #     #    #     #      #    #
#       #      #     #       #    #    #    #     #     #    #     #      #    #
#   ### #      #     #       #    #    #    #     #     #    #     #      #    #
#              #     #       #    #    #    #     #     #          #      #    #
#              #     #       #    #    #    #     #     #          #      ###  #
#              #     #       #    #    #    #     #     #          #      #    #
#              #     #       #         #    #     #     #          #      #    #
#       #      #     #       #         #    ##    #     #    #     #      #    #
#       #      #     #       #         #    #     #     #    #     #      #    #
#       #      #     #       #         #    #     #     #    #     #      #    #
#       #      #     #       #    #    #    #     #     #    #     #      #    #
#       #      #     #####   #    #    #    #     #     #    #     #      #    #
#       #      #     #       #    #    #    #     #     #    #     #      #    #
#       #      #     #       #    #    #    #     #     #    #     #      #    #
#       #      #     #       #    #    #    #     #     #                      #
#       #      #     #       #    #    #    #     #     ############    ########
#       #      #     #       #    #    #    #     #     #      #               #
#       ###          #       #    #    #    #     #     #      #               #
#       #                    #    #    #    #     #     #                      #
#       #                    #    #    #    #     #     #                      #
#       #                    #         #    #     #      ###       #############
#       #      #             ######    #    #     #                      #     #
#       #      #     #            #    #    #     #            #         #     #
#       #      #     #                 #    #     #            #               #
#       #      #     #                 #    #     #     #      #               #
#       #      #     #                 #    #     #     #      #               #
################################################################################
