80 80
################################################################################
#       #     #        #                  #                      #       #     #
#       #     #        #                  #                      #       #     #
#             #        #      #                                  #       #     #
#             #        #      #                    #             #       #     #
#             #        #      #                    #             #       #     #
##########    #        ##     ##    ######         #             #       #     #
#       #     #        #      #           #########    ######### #####   #     #
#       #     #        #      #           #                      #       #     #
#       #     #        #      #           #                              #     #
#       #     #        #      #           #                              #     #
#       #     #        #      #                                          #     #
#       #     #        #      ######    #########################        #     #
#       #     #        #      #     #        #                   #       #     #
#       #     #        #      #     #                            #       #     #
#       #     #        #      #     #                            #       #     #
#       #     #        #      #                             #    #       #     #
#       #     #        #      #                     #       #    #       #     #
#       #     #        #      #      ######    #### #####    ### #       #     #
#       #     #        #      #                     #            #       #     #
#       #     #        #      #     #               #            #       #     #
#       #     #        #      #     #               #            #       #     #
#       #     #        #      #     #               #            #       #     #
#       #     #        #      #     #                            #       #     #
#       #     #        #      #     ####    #################### #       #     #
#       #     #        #      #     #                   #        #       #    ##
#       #     #        #      #     #                   #        #       #     #
#       #     #        #      #     #                   #        #       #     #
#       #     #        #      #     #                            #       #     #
#       #     ##    ## #      #     #                            #       #     #
#       #     #        #      #     ###    #############         #             #
#       #     #        #      #     #          #                 #             #
#       #     #        #      #     #          #        #        #             #
#       #     #        #      #     #          #        #        #             #
#       #     #        #      #     #     #    #        #        #       #     #
#       #     #        #      #    *#     #    #        #        #       #     #
#       #     #        #      #     ####    ## #        #        #       #     #
#       #     #        #      #     #          ####     #####    #       #     #
#       #     #        #      #     #                   #        #       #     #
#       #     #        #      #     #                   #        #       #     #
#       #     #        #      #     #                   #        #       #     #
#       #     #        #            #                            #       #     #
#       #     #        #############    ######################## #       #     #
#       #     #        #      #                            #     #       #     #
#       #     #        #      #                                  #       #     #
#       #              #      #                                  #       #     #
#       #              #      #                                  #       #     #
#       #              #      #                                  #       #     #
#       #              #      #    ############################# #             #
#       #     #        #            #                            ############  #
#       #     #        #                                         #             #
#       #     #        #                                         #             #
#       #     #         ###                                      #             #
#       #     #               #                                  #     #       #
#       #     #               #     #                            #     #       #
#       #     #               #     #                            #     #       #
#       #     #                                                  #     #       #
#             #################################    ############# #     #       #
#             #                              #                   #     #       #
#             #                              #                   #     #       #
#             #                              #                   #     #       #
##      #     #                  #           #                   #     #       #
#       #     #                  #           #                   #     ###    ##
#       #     #######    ####### #                               #     #       #
#       #     #     #            #                               #     #       #
#       #     #     #            #                               #     #       #
#       #     #                  #######################    #### #     #       #
#       #     #                  #                               #     #       #
#       #     #                  #                               #     #       #
#       #     #                  #                               #     #       #
#                                                                #     #       #
################################################    ############ #     #       #
#                   #                                            #     #       #
#                   #                                            #     #       #
#                   #                                            #     #       #
#                                                                #     #       #
#                                                                #     #       #
#                                                                #     #       #
#                                                                #     #       #
################################################################################
