80 80
################################################################################
#                                               #       #         #    #       #
#                                               #       #              #       #
#                                               #       #              #       #
##############      ########    ############### #       #    #         ###    ##
#                  #                            ####    #    #         #       #
#                  #                            #       #    #    #    #       #
#                  #                            #       #    #    #    #       #
#                  #                            #       #    #    #    #       #
#                                               #       #    #    #    #       #
############################################    #       #    #    #            #
#       #     #        #        #               #       #    #    #            #
#       #     #        #        #               #       #         #            #
#       #     #        #        #               #       ######    #            #
#       #     #        #                        #            #    #######    ###
#       #     #        #                 #      #            #    #            #
#       #     #        #              ## #      #                 #            #
#####   #     #        #                 #      #                 #            #
#       ###   #        #        #        #      #       #         #    #       #
#             ##    ## #        #        #      #       #         #    #####   #
#             #        ####     #        #      #       #    #    #    #       #
#             #        #        #        #      #       #    #    #    #       #
#             #        #        #        #      #       #    #    #    #       #
#       #     #        #        #        #      #       #         #            #
#       #     #        #        #        #      #       ##########    ##########
#       #     #        #        #        #      #       #                 #    #
#       #              #        #        #      #       #                 #    #
#       #              #        #        #      #       #                 #    #
#       #              #        #        #      #       #                 #    #
#       #              #######    ###### #      #       ############      ###  #
#       ####    ###### #     #     #     #      #       #                      #
#       #         #    #     #     #     #      #       #                      #
#       #         #    #     #     #     #      #       #                      #
#       #         #    #     #     #     #      #                              #
#       #         #    #    ##     #     #      ###########    #################
#       #         #    #           #     #      #         #        #       #   #
#       #         #    #           #     #      #         #        #       #   #
#       #         #    #           #     #      #         #                #   #
#       #              #           #     #      #         #                #   #
#       #               ##    #### #     #      #         #                #   #
#       #                    #     #     #      ####      #                #   #
#       #######              #     #     #      #         #############    #   #
#       #         #          #     #     #      #         #                    #
#       #         #    #     #     #     #      #         #                    #
#       #         #    #     #     #     #      #         #                    #
#       #         #    #     #     #     #      #         #    #               #
#       #         #    #     #     #     #      #         #    ########    #   #
#       #         #    #     #     #     #      #         #    #     #     #   #
#       #         #    #     #     #     #      #              #     #     #   #
#       #         #    # *   #     #     #      #              #           #   #
#       #         #    #     #     #     #      #              #           #   #
#       #         #    #           #     #      #              #           #   #
#       #         #    #           #     #      #         #    #           #   #
#       #         #    #                 #      #         #                    #
#       #         #    ##                #      #         ######    ############
#       #         #    #     #           #      #         #    #    #    #     #
#       #         #    #     #           #      #         #    #    #    #     #
#       #         #    #     #     #     #      #         #         #    #     #
#       #         #    #     #     #     ####   #         #         #          #
#       #         #    #     ##    #     #      #         #         #          #
#       #         #    #     #     #     #      #         #         #          #
#       #         #    #     #     #     #      #         #    #    #          #
#       #         #    #     #     #     #      #         #    #    #    #     #
#       #         #    #     #     #     #                #    #    #    #     #
#       #         #    #     #     #     #                ###    ## #    #     #
#       #         #    #     #                            #    #    #    ####  #
#       #         #    ####    #################          #    #    #    #     #
#       #         #    #       #        #       #         #    #    #    #     #
#                      #       #        #       #         #              #     #
##############    #### #       #        #       #         #              #     #
#           #     #    #       #        #       #         #              #     #
#           #          #       #        #       #         #          ####    ###
#           #          #    ###                 #         #    #    #          #
#                      #                        #         #    #    #          #
#    #                 #                        #         #    #    #          #
######    ## ###    ## #        ######    ##### #         #    #    #          #
#                      #       #                #         #    #    #    #     #
#           #          #       #                #         #    #    #    #     #
#           #          #       #                #         #    #    #    #     #
################################################################################
