80 80
################################################################################
#                        #         #                       #          #    #   #
#                        #         #                       #          #    #   #
#                                  #                       #          #    #   #
#                                  #       ###    ######## ####    ## #    #   #
#                                  #       #               #          #        #
#                                  #       #                          #        #
##########################    #### #       #                          #        #
#    #     #      #      #    #    #       #                          ##    ####
#    #     #      #      #    #    #       #                          #    #   #
#          #      #      #    #    #       #############    ######### #    #   #
#          #      #      #    #    #       #               #               #   #
#          #      #      #    #    #       #               #                   #
#          #      #      #    #    #       #               #                   #
#    #     #      #      #         #       #                                   #
#    #     #      #      #         #       #                                   #
##    #### #      #      #         #       #                                   #
#    #     #      #      #         #       ########    #########################
#    #     #      #      #    #    #       #                        #          #
#    #     #      #      #    #    ###     #                        #          #
#    #     #      #      #    #    #       #                        #          #
#    #     #      #      #    #    #       #                   #    #    #     #
#    #     #      #      #    #    #       #                   #    #    #     #
#    #     #      #      #    #    #       #                   #    #####    ###
#    #     #      #      #    #    #       #                   #    #      #   #
#    #     #      #      #    #    #       #                        #      #   #
#    #     #      #      #    #    #       #####################    #      #   #
#    #     #      #      #    #    #       #       #           #    #      #   #
#    #     #      #      #    #    #       #       #           #    #      #   #
#          #      #      #    #    #       #       #                #      #   #
#          #      #      #    #    #       #       #                #      #   #
#                 #      #    #    #       #       #                #      #   #
#                 #      #    #    #       #####   #                #      #   #
#    #            #      #    #*   #       #       #                #      #   #
#    #   ##       #      #    #    #       #       #                #      #   #
#    #     #      #      #    #    #       #       #############    #      #   #
#    #     #      #           #    #       #       #    #      #    #      #   #
#    #     #      #           #    #       #       #    #      #    #      #   #
#    #     #      #           #    #       #       #    #      #    #      #   #
#    #     #      #           #    #       #       #    #      #    #      #   #
#    #     #      #           #    #       #       #    ###    #    #      #   #
#    #     #      ##    ##### #    #       #       #    #      #    #      #   #
#    #     #      #           #    #       #       #           #    #      #   #
#    #     #      #           #    #       #       #           #    #          #
##   #     #      #           #    #       #       #           #    #          #
#    #     #      #           #    #       #       #           #    #          #
#    #     #      #           #    #       #       ########    #    #    ##    #
#    #     #      #                #       #       #     #     #           #   #
#    #     #      ########    #### #       #       #     #     #           #   #
#                 #    #    #      #       #       #     #     #           #   #
###############   #    #    #      #       #       #     #     #           #   #
#      #     #    #    #    #      #       #       #     #          #      #   #
#      #     #    #    #    #      #       #       #     #          #      #   #
#      #     #    #    #           #       #             #          #      #   #
#      #     #    #                #       #             #          #      #   #
#  ####      #    #                #       #             ##    #    #      #   #
#            #    #                #       #             #     #    #      #   #
#            #              #      #       #       #     #     #    #      #   #
#            #         #    #      #       #       #           #    #      #   #
#      #     #         #           #       #       #           #    #      #   #
#      #     #         #########   #                                #          #
#      #     #    #    #     #     #################################    ########
#      #     #    #    #     #     #             #       #     #               #
#####    ### #    #    #     #     #             #       #     #               #
#   #        #    #    #     #     #             #       #     #               #
#   #             #    #     #     #                           #               #
#   #             #    #     #     #                           ########    #####
#   #             #    #     #     ########    ##              #     #    #    #
#   #             #    ###   #     #                           #     #    #    #
#   #        #    #    #     ###   #             ###    ###### #     #    #    #
#         ## #    #    #     #     #             #             #     #    #    #
#            #    #    #     #     #             #             #     #         #
#            #    #    #     #     #             #             #               #
#            #    #    #     #     #                           #               #
#   #        #    #    #           ################    ####### #               #
#   #        #    #    #           #           #               #######    #    #
#   #        #    #    #           #           #               #          #    #
#   #        #    #    #                                                  #    #
#   #        #    #    #     #                                            #    #
################################################################################
