80 80
################################################################################
#    #     #    #         #     #     #            #             #             #
#    #     #    #         #     #     #                                        #
#    #     #    #         #     #     #                                        #
#    #     #    #    #    #     #     #                               ##########
#    #     #    #    #    #           #################    ######     #        #
#    #     #    #         #           #                  #       #    #        #
#    #     #    #######   #   ##      #                  #       #             #
#    #     #    #    #    #           #                          #             #
#    #     #    #    #          #     #                          #             #
#    #     #    #    #          #     #                                        #
#    #     #    #    #          #     ################################    ######
#    #     #    #               #                            #                 #
#    #     #    #               #                                              #
#    #     #    #               #                                              #
#    #     #    #############   #                                              #
#    #     #    #    #    #     #     #                                        #
#    #     #    #         #     #     #                                        #
#    #     #    #         #     #     #                                        #
#    #     #    #         #     ###    #########################################
#    #     #    #         ##    #                                 #            #
#    #     #    #######         #                                 #            #
#    #     #    #               #                                              #
#    #     #    #               #                                              #
#    #     #    #               #                                              #
#    #     #    #                                                              #
#    #     #    #############################################    ###############
#    #          #       #        #      #               #          #     #     #
#               #       #        #      #                          #     #     #
#               #       #        #      #                                #     #
#               #       #        #      #                                #     #
#          #    #       #        #      #                                ##    #
#    #     #    #       #        #       ##########    ############      #     #
#    #     #    #       #        #            #                    #     #     #
#    #     #    #       #        #            #                    ###   #     #
#          #    #       #        #            #                    #     #     #
#######    #    #       #        #      #                          #     #     #
#    #     #    #       #        #      # *                        #     #     #
#    #     #    #       #        #      #                                #     #
#    #     #    #       #        #      ####    ######################## #     #
#    #     #    #       #        #      #           #             #      #     #
#    ##    #    #       #        #      #           #             #      #     #
#    #     #    #       ######   #      #           #                    #     #
#    #     #    #       #        #      #                   #            #     #
#          #    #       #        #      #                   #            #     #
#          #    #       #        #      #                   #            #     #
#          #    #   ### #        #      #                   #     #      #     #
#          #            #        #      #############    ## #     #      #     #
#    #     #            #        #      #                   ######    ###      #
#    #     #            #        #      #                   #                  #
#    #     #            #        #      #                   #                  #
#    #     #    #       #        #      #                   #                  #
#    #     #    #       #        #      #                                      #
#    #     #    #       #        ##     ########    ############################
#    #     #    #       #        #      #      #        #                      #
#    #     #    #       #        #      #      #        #                      #
#    #     #    #       #               #               #                      #
#    #     #    #       #               #               #                      #
#    #     #    #       #               #               #    ###################
#    #     #    #       #               #               #                      #
#               #       #        #      #               #                      #
#############   #       #        #      ##########      #                      #
#               #       #        #      #               #      #               #
#               #       #        #      #               #   ## ####    #########
#               #                #      #               #      #               #
#               #                #      #       #              #               #
#        #      #                #      #       #              #               #
#        #      #                #                                             #
#   #### #      #       #        ###    ########################################
#   #    #      ####    ######## #                  #                          #
#        ####   #         #      #                                             #
#        #      #         #      #                                             #
#        #      #         #      #                                         #   #
#        #      #         #      #                           #             #   #
#   #    #      #    #### #      #                           #             #   #
#   #    #      #         ###    ########################    ############    ###
#   #    #      #                #                           #                 #
#   #    #      #                #                           #                 #
#   #    #      #                #                           #                 #
################################################################################
