80 80
################################################################################
#       #         #      #        #               #    #    #                  #
#       #         #      #        #               #    #    #                  #
#       #         #      #        #               #    #    #                  #
#       ##    ### #               #        #      #    #    ##    ##### ##    ##
#       #    #    #               #        #      #    #    #     #    #       #
#       #    #    #               #        #      #    #    #     #    #       #
#       #         #               #   #### #      #    #    #     #    #       #
#       #         ###    #    ### #        #      #    #    #     #    #       #
#       #                #        #        #      #    #    #     #    #       #
#       #                #        #        #           #    #     #    #       #
#       #    #           #        #        #           #    #          #       #
#       #    #                    #                    #    #          #       #
##      #    #    #   ########### #####    #######          #          #       #
#       #    #    #    #                 #        #         #          #       #
#       #    #    #    #                 #        #         #          #       #
#       #    #    #    #                 #        #         #                  #
#       #    #    #    #                 #        #    #    #################  #
#       #    #    #    #######    #      #        #    #    #                  #
#       #    #    #    #    #     #      #        #    #    #                  #
#       #    #    #    #    #     #      #        #    #    #                  #
#       #    #    #    #          #      #        #    #    #         #        #
#       #    #    #               #      #        #    #    #         ###    ###
#       #    #    #               #          #### #    #    #######   #    #   #
#       #    #    #               #               #    #    #    #    #    #   #
#       #                         #               #    #         #    #    #   #
#       ############    ######### #               #    #         #    #        #
#             #                   #   ## #        #    #              #        #
#                                 #      #        #    #              #        #
#                                 #      #        #    #    #         #        #
#                                 #      #        #    #    #         #    #   #
#       ###    #########    ##### #      #        #    #    #         #    #   #
#       #     #                   #      #        #    #              #        #
#       #     #                   #                    ############    #########
#       #     #                   #########    ####### #    #          #       #
#                                 #      #       #     #               #       #
##############################    #      #             #               #       #
#           #     #               #      #             #               #       #
#                 #               #      #             #               #       #
#                 #               #      #             #               #       #
#                 #               #      #             #               #       #
#                 #          #    #      #####    #### #   ########### #       #
#                 ############    #      #             #         #     #       #
#                 #        #      ##     #             #         #     #       #
######    ########         #      #      #             #         #     #       #
#                          #      #                    #         #     #       #
#                                 #           #        #####     #     #       #
#                                 #           #        #    #    #     ##    ###
#                                                      #    #    #     #       #
####################    ############################## #    #    #     #       #
#          #    #     #                                #    #    #     #       #
#          #    #     #                                #    #    #     #       #
#          #    #     #                                #    #    #     #       #
#          #          #                                #    #    #     #       #
###    ### #          ######################    ###### #    #    #     #       #
#          #          #        #        #              #    #    #     #       #
#          ##    #####         #                       #    #    #     #       #
#          #                   #                       #    #    #     #       #
#     #                        #                       #    #    #     #       #
#     #                        #                       #    #    #     #       #
#                     #        ##############    ##### #    #    #     #       #
###########    ###### #        #       #               #    #    #     #       #
#       #     #       #        #       #               #    #    ##    #       #
#       #     #       ###      #       #               #    #    #     #       #
#       #     #       #        #       #               #         #     #       #
#       #     #       #        #       #               #         #             #
#       #     #       #        #       #   ########### #         #             #
##      #     ####    #        #       #    #          #         #             #
#       #     #       #        #       #    #          #    #    #             #
#             #       #                #               #    #    #     #       #
#                     #                #         #*    #    #    #     #       #
#                     #                #         #     #    #    #     #       #
#                     #                ###    ## #     #    #    #     #       #
#       #             #        #       #    #    ##    #    #          #       #
#########    ##       #        #       #    #    #     #    #          #       #
#      #      #       #        #       #    #    #     #    #          #       #
#             #       #        #       #    #    #     #    #          #       #
#             #       #        #                 #     #    #    #     #       #
#             #       #        #                 #     #    #    #     #       #
################################################################################
