80 80
################################################################################
#    #              #     #     #              #      #       #    #     #     #
#    #              #           #              #      #       #    #     #     #
#    #     #                    #       #      #      #       #    #     #     #
#  ##      #                    #       #      #              #    #     #     #
#          #                            #      #              #    #     #     #
#                         #             #      #              #    #     ####  #
#     ###########   #     #             #      ##########     #    #     #     #
#    #              #                   ####   #              #    #     #     #
#    #              ##    ##### #       #      #              #    #     #     #
#    #              #           #       #      #              #          #     #
#    #              #           #       #      #              #          #     #
#    #      #       #           #       #      #        #     #          #     #
#    #      #       #           ##      #      #        #     #####      #     #
#    #                    #     #       #      #        #     #    #     #     #
#    #################    ##### #       #      #        #     #    #     #     #
#    #         #                #       #      #        #     #    #     #     #
#    #         #                #       #      #        #     #    #     #     #
#    #         #                #       #      #   #### #     #     ##   #     #
#    #         #                #       #      #        #     #          #     #
#    #    ##### ###########     #       #      #        #     #          #     #
#    #                          #       #      #        #     #          #     #
#    #                          #       #      #        #     #    #     #     #
#    #                          #       #      #        ##    #    #     #     #
#    #         #                #       #      #        #     #    #     #     #
#              #                #       #      #        #     #    #     #     #
##############    ############# #       #               #     #    #     #     #
#        #                      #       #               #     #    #           #
#        #                      #       #               #     #    #           #
#        #                      #       #               #     #    #           #
#        #                      #       #      #        #     #    #           #
####     #                      #       #      #        #     #    #     #     #
#        ####################   #       #               #     #    #     #     #
#        #                 #    #       ##############    ### #    #     #     #
#        #                 #    #       #      #       #      #    #     #     #
#                          #    #       #      #       #      #    #     #     #
#                               #       #      #       #      #    #     #     #
#                               #       #      #       #      #    #     #     #
#                               #       #      #####   #      #    #     #     #
#        #                      #       #      #       #      #    #     #     #
#        #                      #       ##     #       #      #    #     #     #
#                                       #      #       #      #    #     #     #
###    ################################ #      #              #    #     #     #
#            #     #        #           #      #              #    #     #     #
#            #     #        #           #      #              #                #
#            #              #           #      #              ###############  #
#      #                    #           #      #    ######### #    #      #    #
#      #                    #      #    #      #     #        #    #      #    #
#      #      ##########    #      #    #      #     #        #    #      #    #
#                  #        #      #    #      #     #        #    #      #    #
#########    #     #        #      #    #      #     #        #    #           #
#            #     #        #      #    #      #     #        #    #           #
#            #              #      #    #            #        #    #           #
#            #              #      #    #            #        #    #    ########
#                           #      #    #            #        #    #    #      #
#####    ################## #      #    #            #             #    #      #
#           #               #      #    #      #                   #    #      #
#           #               #           #      #             *     #    #      #
#           #               ########    #      #         #####     #    #      #
#                           #     #     #      #              #    #    #      #
#                           #     #     #      #     #        #    #    #      #
#                           #     #     #      #     #        #    #    #      #
#                                       #      #     #        #    #    #      #
#                                       #      #     #        #    #    #      #
#                                                             #    #    #      #
##############    ########################################### #    #    #      #
#   #                      #                      #           #    #    ####   #
#                          #                      #           #    #    #      #
#                          #                      #           #         #      #
#                          #                                  #         #      #
#                                                             #         #      #
#   #                                                         #         #      #
#   #                                                         #    #    #      #
#                                                             #    #    #      #
#####    ################# #####################    ######### #    #    #      #
#         #                #         #                        #    #    #      #
#                          #         #                        #    #    #      #
#                          #                                  #    #           #
#                          #                                  #    #           #
################################################################################
