80 80
################################################################################
#         #                      #        #                #        #      #   #
#         #                      #        #                #        #      #   #
#         #                      #        #                #        #      #   #
#   ######                       #        ###    ######### #        #      #   #
#                                         #    #      #    #        #      #   #
#                                         #    #           #        #      #   #
#                                         #    #           #        #      #   #
#         #    ########################## #    #           #        #      #   #
#   #     #                               #    #           #        #      #   #
#   #     #                               #    #           #        #      #   #
#   #     #                               #    #####    ## #        #      #   #
#                                         #    #    #      #        #          #
#   ##################################### #    #    #      ######   #          #
#      #       #     #           #        #    #    #               #          #
#      #       #     #           #        #    #    #               #          #
#      #             #           #        #    #    #               #      #   #
#      #             #    #      #        #    #                    #      #   #
#      #             #    #      #        #    #           #        #      #   #
#      #             #           #        #    #           #        #      #   #
#      #       #     #########   #        #    #           #        #      #   #
#      #       #     #      #    #        #         ###    #        #      #   #
#      #       #     #      #    #        #         #      #        #      #   #
#      #       #     #      #    #                  #      #        #      #   #
#      #   ### #     #      #    #                  #      #        #      #   #
#      #       #                 #                  #      #        #      #   #
#      #       #                 #                  #               #      #   #
#      #       #          ##     #   #### ##########    ########### #      #   #
#      #                         #        #        #        #       #      #   #
#      #########    ##      #    #        #        #        #       #   ## #   #
#      #    #        #      #    #        #        #        #       #      #   #
#      #    #        #      #    #        #        #        #       #      #   #
#      #             #      #    #        #        ######   #       #      #   #
#                    #      #    #        #        #        #       #      #   #
#                                #        #        #        #       #      #   #
#       ####    ################ #        #        #        #       #      #   #
#                                #        #                 #       #      #   #
#      #                         #        #                 #       #      #   #
#      #                         #        #                 #       #      #   #
#      #         #               #        #                 #       #      #   #
#      #         #               #        #    ### #        #       #      #   #
#      #         #               #        #        #        #       #      #   #
#                                #        #        #        #       #      #   #
#  ############################# #        #        #                #      #   #
#                                #        #        #                #      #   #
#                                #        #        #                #      #   #
#                                         #        #                #      #   #
#              #                          #        #        #       #      #   #
############   #                          #        #        #       #      #   #
#      #       ######    ########         #########    #### #       #      #   #
#      #       #                 #        #     #           ###     #      #   #
#      #       #                 #        #                 #       #      #   #
#              #                 #        #                 #       #      #   #
#              #     #           #        #                 #       #      #   #
#              #     #           #        #                 #    *  #      #   #
#                                         #                         #      #   #
##########################################    ##################### #      #   #
#            #                            #        #                #      #   #
#            #                            #        #                #      #   #
#                                         #        #                #      #   #
#                  #                      #                         #      #   #
#                  ############    ###### #                         #      #   #
###    ########### #                #     #                         #      #   #
#                  #                #     #                         #      #   #
#                  #                      #                         #          #
#                  #                      #                         ###    #####
#                                         ################    ##### #      #   #
####################    ################# #            #            #      #   #
#        #                       #        #            #            #      #   #
#        #                                #            #            #      #   #
#        #                                #            #            ###    #   #
#        #                                #######      #            #      #   #
#  ##### #                                #     #      #    ####### #      #   #
#        #                                #     #      #       #    #      #   #
#        #                                #     #              #               #
#        ###############    ############# #                    #               #
#   #    #                                                                     #
#   #                                                                          #
#   #                                                  #            #      #   #
################################################################################
