80 80
################################################################################
#       #        #                        #                      #         #   #
#       #        #                        #                      #         #   #
#       #        #                  #     #                                #   #
#       #        #                  #     #                                #   #
#       #        #                  #     #   ########## #                 #   #
#       #        #                        #     #        ###                   #
#       #        #######    ############# #     #        #       #             #
#       #        #                              #        #       #             #
#       #        #                                       #       ############  #
#       #        #                                       #       #        #    #
#       #        #                                       #       #        #    #
#       #        #########################    ########## #       #             #
#       #        #                  #                    #       #             #
#       #        #                  #                    #                     #
#       #        #                  #                    ####################  #
#       #                           #                    #                 #   #
#       #                           #                    #                     #
#                                   ###############      #                     #
#                 ######    ########        #            #                     #
#                #         #                             #            #        #
#                #         #                             #   ######## #        #
#       #        #                                       #     #      ##    ####
#       #        #                  ###      ########    #     #      #    #   #
#       #        #######    ##      #       #       #    #     #      #    #   #
#       #        #                  #       #       #    #     #      #    #   #
#       #        #         #        #       #            #            #    *   #
#       ####     #         #        #       #            #            #        #
#       #        #                                                             #
#  #### #        ###########################################################   #
#       #        #       #         #         #      #          #      #    #   #
#       #        #       #         #         #      #          #      #    #   #
#       #        #       #         #                #          #      #    #   #
#       #        #       #         #                #          #      #    #   #
#                #       #    #    #                ######     #           #   #
#    ########### #            #    #                #    #     #           #   #
#          #     #            #    #    ########### #    #     #           #   #
#          #     #            #    #                #    #         ###     #   #
#          #     ####         #    #                #                 #        #
#          #     #       #    #    #                #                 #        #
#          #     #       #    #    #           #    #                 #        #
#          #     #       #    #    #     #     #                      #        #
#    ##### #     #       #    #    #     #     #                      #    #   #
#    #     #     #       #    #    ###    #### #     ######    ###### #    #   #
#    #     #     #       #    #    #     #     #                      #    #   #
#    #     #     #       #    #    #     #     #    #                 #    #   #
#    #     #     #       #    #    #           #    #                 #    #   #
#    #     #     #       #    #    #           #    #                 #    #   #
#    #     #     #       #    #    #                                  #    #   #
#    #     #     #       #    #    #########################    ##### #    #   #
#    #     #     #       #    #    #                                  #    #   #
#    #     #     #       #    #    #                                  #    #   #
#    #     #     #       #    #    #                                  #    #   #
#    #     #     ########     #    #                                       #   #
#    #     #     #     #      #    ###############    #################### #   #
#    #     #     #     #      #    #                    #          #       #   #
#          #     #            #    #                    #          #       #   #
#                #            #    #                    #          #       #   #
#                ###    ##    #    #                    #          #       #   #
#                #            #    #                    #                  #   #
#    #           #     #      #    ###    ############# #                  #   #
#    #     #     #     #      #    #                    #                  #   #
#    #     #     #     #      #    #                    #                  #   #
#    #     #     #     #      #    #                    #####    ######### #   #
#    #     #     #     #           #       #                               #   #
#    #     #     ####    ######### #       #                               #   #
#    #     #     #            #    #       #                               #   #
#    #     #     #            #    #                                           #
#    #     #     #            #    ##################    #######################
#    #     #     #            #    #    #                                      #
#    #     #     #      #     #    #    #                                      #
#    #     #     ########     #    #    #                                      #
#    #     #     #      #     #                                                #
#    #     #     #      #     #                    #########################   #
#    #     #     #      #     #                    #                           #
#    #     #     #                  ###########    #                           #
#    #     #     #                 #               #                           #
#    #     #     #                 #               #        #                  #
#    #     #     #                 #               #        #                  #
################################################################################
