80 80
################################################################################
#   #       #    #                                                             #
#   #       #    #                                                             #
#   #       #    #                                                             #
#   #       #    #                #                                            #
#           #    #    #           ###########################    ###############
#           #    #    #           #                                            #
#           #    ##    ########## #                                            #
#    ###### #    #                #                                            #
#   #       #    #                #             #                              #
#   #       #    #                #             #                              #
#   #       #    #       #        #             #                              #
#   #       #    #       #        #             #                              #
#   #       #    #                                                             #
#   #       #    ######################################    #####################
#   #       #    #    #                                  #     #    #          #
#   #       #    #    #                                  #     #    #          #
#           #    #    #                                  #     #    #          #
#           #    #    #                                  #     #    #          #
#    ##     #    #    ################    ############## #     #    #          #
#           #    #    #      #      #     #         #    #     #    #    #######
#   #       #    #    #      #      #     #         #    #          #      #   #
#   #       #    #    #      #      #     #         #    #          #      #   #
#   #       #    #    #      #      #     #         #    #          #      #   #
#   #       #    #    #      ###    #     #    #### #    ###    ### #          #
#   #       #    #    #      #      #     #    #    #    #     #    #          #
#   #       #    #    #      #      #     #    #         #     #    #          #
#   #       #    #    #             #     #    #         #     #    #          #
#   #       #    #                  #     #    #         #     #    #      #   #
#   #       #    #                  ###   #    #         #     #           #   #
#   #       #    #                  #     #         #    #     #           #   #
#   #       #    #           #      #     #         #    #     #           #   #
#   #            #    #      #      #     #              #     #           #   #
#   #            #    ####   #      #     ############   #          ####   #   #
#   #            #    #      #            #     #        #          #      #   #
#   #            #    #      #            #     #        #          #      #   #
#   #       #    #    #      #            #              #          #      #   #
#   #       #    #    #      #            #              #                     #
#   #       #    #    #      #      #     #              ####    ###############
#   #       #    #    #      #      #                    #      #          #   #
#   #       #    #    #      #      #           #        #      #          #   #
#   #       #    #    #      #      #           #        #      #          #   #
#   #       #    #    #      #      #           #        #      #          #   #
#   #       #    #    #      #      #     #     #        #      #          #   #
#   #            #    #      #      #     #     #        #      #          #   #
##    ########## #    #      #      #     #     #        #      #          #   #
#      #    #    #    #      #            #     #        #      #          #   #
#      #    #    #    #      #   ######## #     #        #      #          #   #
#      #    #    #    #      #            #     #        ###    #          #   #
#      #    #    #    #      #            ###   #        #      #          #   #
#      #    #    #    #      #            #     #        #      #          #   #
#      #    #    #    #      #            #     #        #      #              #
#      #    #    #    #                   #     #        #      #              #
#           #    #    #########    ###### #     #        #      #######        #
#           #    #    #          #        #     #        #      #              #
#           #    #    #          #        #     #        #      #          #   #
#           #    #    #          #        #     #               #          #   #
#      #         #    #                   #     #               #          #   #
#      #         #    #                   #     #               #              #
##     #         #    ####    ###         #     #               #####    #######
#      #              #     #             #     #        #      #       #      #
#      #    #         #     #    #        #     #        #      #       #      #
#      #    #         #     #    #        #     #        #      #       #      #
#      ##    ####     #     #    #        #     #        #              #      #
#      #         #    #     #    #        #     #        #          #### ####  #
#      #         #    #     #    #        #     #        #                     #
#      #         #    #          #   #### #     #        #                     #
#      #         #    #          #        #     #        #      #              #
#      #         #    #          #        #     #        #      #       #      #
#      #    #    #    #          #        #     #        #      #       #      #
#      #    #    #    #     #    #        #     #   #### #      #       #      #
#      #    #    #    #     #    #        #     #        #      #       #      #
#      #    #    #    #     #    #        #     #        #      #       #      #
#      #    #    #    #     #    #        #     #        #      #       #      #
#      #    #    #                           *           #      #       #      #
#      #    #    #################################    ## #      #       #      #
#      #    #    #                                       #      #       #      #
#      #    #    #                                       #      #       #      #
#      #    #    #                                       #      #       #      #
################################################################################
