80 80
################################################################################
#       #                                     #        #               #       #
#       #                                     #        #               #       #
#       #     #                               #        #               #       #
#             #######################    #### #        #    #          #       #
#             #                               #        #    #                  #
#             #                               #        #                       #
#             #                               #        ###########             #
#       #     #                               #        #     #                 #
#       #     ##    #################     ### #        #               #       #
#       #     #                      #        #        #               #       #
#####   #     #                      #        #        #               #       #
#       #     #                      #        #        #      ####     ####    #
#       #                            #        #        #     #    #    #       #
#       ##########################    ####### #        #     #    #    #       #
#       #     #    #            #             #        #     #    #    #       #
#       #     #    #            #             #        #     #    #    #       #
#       #     #    #            #             #        #     #         #       #
#       #     #    #            #     #       #####          #         #       #
#       #     #    #     #      #     #       #                                #
#       #     #          #      #     #       #         #####################  #
#       #     #          #      #     ###     #                  #             #
#       #     #          #      #     #       #        #         #             #
#       #     #          #            #       #        #         #             #
#       #     #    #     #            #       #        #         #             #
#       #     #    #     #                    #        ######    #             #
#       #     #    #     #       #######      #        #         #             #
#       #     #          #      #     #       #        #         ####    #######
#       #     ######     #      #     #       #        #         #             #
#       #     #          #   ## #             #        #                       #
#       #     #          #      #             #        #    #                  #
#       #                #      #                      #    #                  #
#       #                #      #                      #    #             #    #
#       #          #     #      #     #                #    #    #        #    #
#       #          #     #      #     #                #    #    #        #    #
#       #          #     #      #     #       #                  #             #
#       #          #     #      #     #       ################    ##############
#       ##########    ## #      #     #####   #      #      #       #     #    #
#       #        #       #      #     #       #      #      #       #     #    #
#       #        #       #      #     #       #      #              #          #
#       #        #       #      #     #       #      #              #          #
#       #        #       #      #     #       #      #                         #
#       ####     #       #      #     #       #      #                         #
#       #        #       #      #     #       ####    #########      #######   #
#       #        #       #                    #               #           #    #
#       #        #   ### ########    ######## #                     #     #    #
#       #        #       #       #            #                     #     #    #
#       #        #       #       #            #                     #     #    #
#       #        #       #       #            #                     ###   #    #
#       #        #       #                    ###########    ###### #     #    #
#       #                #                    #                     #     ##   #
#       #                #                    #                     #          #
#       #                #                    #                     #          #
#       #                #       #            #                     #          #
#       #                #       #            #                     #          #
#       #                                                                      #
#       ##################################################################    ##
#       #       #      #                  #                                    #
#       #       #      #                  #                                    #
#       #              #                  #                                    #
#       #              #                                                       #
#       #                                           *                          #
#       #                                                                      #
#       #    ########## ####################    ################################
#       #         #                   #                                        #
#       #         #    #                                                       #
#       #         #    #                                                       #
#       #         #    #       #                                  #            #
#       ###    ## #    #       #                                  #            #
#       #    #    #    #       #      #                           #            #
#       #    #    #    #   ### #      #                           #            #
#       #    #    #    #       #      ############################    ##########
#       #    #    #    #       #      #          #                             #
#       #    #    #    #       #      #                                        #
#       #         #    #              #                                        #
#       #              ###########    #                                        #
#       #              #              #                                        #
#       #              #              #          #                             #
#       #    #         #              #          #                             #
################################################################################
