80 80
################################################################################
#                                                                          #   #
#                                                                          #   #
#                                                                          #   #
############################      ###############################    ##### #   #
#                        #       #                                         #   #
#                                #                                         #   #
#                                #                                         #   #
#                                #                                         #   #
#                                                                          #   #
#############    ######################################################### #   #
#   #    #     #    #    #    #      #    #    #        #        #    #    #   #
#   #    #     #    #         #      #    #    #        #        #    #    #   #
#   #          #    #         #      #    #    #        #        #    #    #   #
#   #          #    #         #      #    #    #        #        #    #    #   #
#   #          #              #      #    #    #        #        #    #    #   #
#   #          #              #      #    #    #    ### #        #    #    #   #
#   #          #              #      #    #    #        #        #    #    #   #
#   ###    ### #     #####    ##    ##    #    #        #             #    #   #
#   #    #          #         #           #    #        #             #    #   #
#   #    #          #         #           #             #             #    #   #
#   #    #          #         #           #             #             #    #   #
#   #                         #           #             #        #    #    #   #
#   #          ########    ## ##    ##### #########     #        #    #    #   #
#   #          #      #       #    #      #      #      #        #    #    #   #
#   #          #      #       #    #      #      #      ##    ## #    #    #   #
#   #    #     #              #    #      #             #        #    #    #   #
#   #    #     #              #    #      #             #        #    #    #   #
#   #    #     #              #    #      #       ###   #        #    #    #   #
#   #    #     #              #    #      #                      #    #        #
#   #    #     #              #    #      #      #               #    #        #
#   #    #                    #    #      #      #               #    #        #
#   #####    ################ #           #      #               #             #
#   #                #        #           #      #      #        #         #   #
#   #                #        #           #             #        #         #   #
#   #                #        #           ##############    #### #         #   #
#   #                #        #    #      #    #     #    #      #    #    #   #
#   #####    ####### #    ####     #   ## #    #     #    #      #    #    #   #
#   #           #    #             #      #    #     #    #      #    #    #   #
#   #                #             #      #          #    #      #         #   #
#   #                              #      #          #    #      #    #### #   #
#   #                              #      #          #    #      #         #   #
#   #                                     #          #    ####   #         #   #
#   #######    ########################## #    #     #    #      #         #   #
#   #          #           #              #    #     #    #      #         #   #
#   #                      #              ##    #### #    #      #    #    #   #
#   #                      #              #     #    #    #      #    #    #   #
#   #                      #              #          #    #      #    #    #   #
#   #                       ##    ####### #          #    #      #    #    #   #
#   #                           #    #    #          #           #    #    #   #
#   #                           #    #    #          #           #    #    #   #
#   #################    ##     #    #    #     #    #           #    #    #   #
#   #      #               #         #    #     #    #           #    #    #   #
#   #      #               #         #    #     #    #    #      #    #    #   #
#          #               #         #    #     #    #    #      #    #    #   #
#          #               #######   #    #     #    #    #      #    #    #   #
#       ## #######    #### #              #     #    #           #    #    #   #
#                          #                    #    #   ####### #    #    #  *#
#   #                      #                    #    #    #      #    #    #   #
#   #                      #    #          ##   #    #    #      #    #    #   #
#   #                      #    #    #          #    #           #    #    #   #
#   #                      #    #    #    #     #    #           #    #    #   #
#   #                                     #     #                #    #    #   #
#    #################################### #     #                #    #    #   #
#       #       #                         #     #         #      #    #    #   #
#               #                         #     #         #   ## #    #    #   #
#               #                         #     #    #    #      #    #    #   #
#               #                         #     #    #    #      #    #    #   #
#            ### ############    ######## #     #    #    #      #    #    #   #
#       #                                 #                                #   #
#       #                                 #############################    #   #
#       #                                 #                       #        #   #
#       #                                 #                       #        #   #
#       ##########################    ### #                       #        #   #
#       #         #                       #                       #        #   #
####    #                                 #   #################### #####   #   #
#       #                                 #                                #   #
#       #                                 #                                #   #
#       #                                 #                                #   #
################################################################################
