80 80
################################################################################
#          #                                                #    #         #   #
#          #                                                #    #         #   #
#          #                                                #    #    #    #   #
#          #                                         ####   #    #    #    #   #
#    ##### ############    ######################### #      #    #    #    #   #
#     #    #                                         #      #    #    #        #
#     #                                              #      #    #    #        #
#     #                                              #      #    #    #        #
#     #                                     #        #      #    #    #        #
#  ## #                                     #        #      #    #    #    #   #
#     #    #                                #        #      #    #    #    #   #
#     #    #                                #        #      #    #    #    #   #
#     #    #                                #               #    #    #    #   #
#     #    #################################    ########### #    #    #####    #
#     #    #                                                #    #    #    #   #
#     #    #                                                #    #    #    #   #
#     #    #                                                #    #    #    #   #
#     #    #                                      #         #    #    #    #   #
#          #                                      #         #    #    #        #
#          #                                      #         #    #    #        #
#                                                           #    #             #
###############    ######################################## #    ##########    #
#             #            #               #                #    #      #      #
#             #            #               #                #    #      #      #
#             #            #               #                #           #      #
#             #    #       #               #                #           #      #
##    ####### #    #       ###########     ###    ## ##     #           #      #
#      #      #            #       #       #         #      #           #      #
#      #      ######    ###        #       #         #      #    #      #      #
#      #      #                    #       #         #      #    #      #      #
#                                  #       #                #    #      #      #
#                           ####   #       ###########      #    #      #      #
#                          #       ##      #     #    #     #    #      #      #
########################   #       #       #     #    #     #    #      #      #
#              #           #       #       #     #    #     #    #      #      #
#              #           #       #       #     #    #     #    #      #      #
#                          #               #     #               #      #      #
#                          #               #     #               #      #      #
#                                          #     #               #      #      #
################################    ###### #     #               #      #      #
#      #    #       #    #                 #     #    #     #    #      #      #
#      #    #       #    #                 #     #    #    *#    #      #      #
#      #    #       #    #                 #     #    #     #    #      #      #
#      #    #       #    #                 #     #    #     #    #      #      #
#           ##      #    #                       #    #     #    #      #      #
#                   #    #    #############      #    #     #    #      #      #
#                   #         #                  #    #     #    #      #      #
#    ##             #         #                ##     ###   #    #      #      #
#      #            #                      #          #     #    #      #      #
#      ###    ######                       #          #     #    #      #      #
#      #     #           #                 #          #     #    #      #      #
#      #     #           #                 #     #    #     #    #      #      #
#      #                                   #     #    #     #    #      #      #
#      #            #######    ########### #     #    #     #    #      #      #
#                   #     #                #     #    #     #    #      #      #
#  ################ #     #                #     #    #     #    #      #      #
#                   #     #                #     #          #    #      #      #
#                   #     #     #          #     #    ##### #    #      #      #
#                   #           #          #     #    #     #    #             #
#                   #                      #     #          #    #             #
#    #              ###    #########    ## #     #          #    #             #
#    ###    ####### #                      #     #          #    #             #
#    #              #     #                #     #          #    #      #      #
#    #              #     #                #     #    #     #    #      #      #
#    #              #     #                #     #    #     #    #      #      #
#                                                #               #      #      #
#################################################    ########### #      #      #
#                 #               #                              #      #      #
#                                 #                              #      #      #
#                                 #                              #      #      #
#                                 #                              #      #   ####
#                                 #########################      #      #      #
#                                 #                        #     #      #      #
#                                 #                        #     #      #      #
#############    ################ #                        #     ####   #      #
#                                                          #     #      #      #
#                                                                #      #      #
#                                                                #      #      #
################################################################################
