80 80
################################################################################
#    #          #     #     #    #                                 #       #   #
#               #     #     #    #                                 #       #   #
#               #     #     #    #                                 #       #   #
#               #           #    ############################      #       #   #
#               #           #    #               #    #    #       #       #   #
#               #                #               #    #    #       #       #   #
#  ############ #                                #    #    #       #       #   #
#   #     #     #                           #    #    #    #       #       #   #
#   #     #     ####    ####      #####     #    #    #    #       #       #   #
#   #     #     #           #          #    #    #    #    #       #       #   #
#   #     #     #           #    #     #    #    #    #    #       #       #   #
#   #     #     #           #    #     #    #    #    #    #       #       #   #
#   #     #     #           #    #     #    #    #    #    #       #       #   #
#   #     #     #########    ### #     #    #    #    #    #       #       #   #
#   #     #     #       #        #     #    #    #    #    #       #       #   #
#   #     #     #       #        #     #    #    #    #    ##      ##      #   #
#   #     #     #       #        #     #    #    #    #    #       #       #   #
#   #     #     #       #        #     #    #    #    #    #       #       #   #
#   #     #     #       #        #     #    #    #    #            #       #   #
#   #     #     #       #        #     #    #    #    #            #       #   #
#   #     #     #       #        #          #    #    #            #       #   #
#   #     #     #       #        #          #    #                 #       #   #
#   #     #     #       #        #          #    #         #       #       #   #
#   #     #     #       #        ########    ### #         #       #       #   #
#   #     #     #       ###      #          #    #         #       #           #
#   #     #     #       #        #          #    #    #    #       #           #
#   #     #     #       #        #          #         #    #       #           #
#   #     #     #                #     #    #         #    #       #           #
#   #     #     #                #     #    #         #    #       #       #   #
#   #     #     #                #     #    #         #    #       #       #   #
#   #     #     #                #     #    #    #    #    #       #       #   #
#   #     #     #       #        #     #         #         #       #       #   #
#   #     #     #       #        #     #         #   ##### #       #       #   #
#   #     #     #       #        #     #         #         #       #       #   #
#   #     #     #       #        #     #         #         #       #       #   #
#   #     #     #####   #        #     #    #    #         #       #       #   #
#   #     #     #       #        ####    ## #    #                 #       #   #
#   #     #     #       #        #          #    ###############   #       #   #
#   #     #     #       #        #          #    #                 #       #   #
#   #     #     #       #        #          #    #                 #       #   #
#   #     #     #       #        #          #    #                 #       #   #
#   #     #     #       #        #     #    #    #    #                    #   #
#   #     #     #       #        #     #    #    #    ##########           #   #
#   #     #     #       #        #     #    #    #    #                    #   #
#   #     #     #       #        #     #    #    #    #                    #   #
#   #     #     #       #        #     #    #    #    #            ######    ###
#   #           #       #        #     #    #    #    #       #    #     #     #
#   #           #       #        #     #    #    #    #       #    #     #     #
#   #           #       #                                          #     #     #
#   #           ######    ######################################## #     #     #
#   #     #     #                                                  #           #
#   #     #     #                                                  #           #
#   #     #     #                                                  #           #
#         #     #                                                              #
#         #     ##    ##########################################################
#         #     #             #                                    #           #
#         #     #             #                                                #
#   #     #     #             #                                                #
#   #     #     #     #       #                                                #
#   #     #     #     #       #       #                                        #
#   #     #     #     #       #   ### #                                        #
#   #     #     #             #       #                                        #
#   #     #     #######    ## #       ###################    ###################
#   #     #     #                     #           #         #                  #
#   #     #     #                     #           #         #                  #
#   #     #     #                     #           #         #                  #
#   #     #     #                     #                     #                  #
#   #     #     ###    ############## #                     ######    ##########
#   #     #     #            #        #                     #            #     #
#   #     #     #            #        #                     #            #     #
#   #     #                  #        #                     #            #     #
#   #     #                  #        #######    ########## #            #     #
#   #     #                  #   #### #             *       #     #      #     #
##    ### #         #########         #                           #######    ###
#         #     #                     #                             #          #
#         #     #                     #                             #          #
#         #     #                     #     #                                  #
#         #     #     #      #        #     #               #            #     #
################################################################################
