80 80
################################################################################
#                       #             #    #      #       #     #    #     #   #
#                                     #    #      #       #     #    #     #   #
#                                     #    #      #             #    #         #
#                                     #    ####                      #         #
#                                     #    #                         #         #
##########    ########################     #                         #         #
#                #                         #       ##########        #     #   #
#                #                         #      #    #        #    #     #   #
#                #                         #      #    #        #    ####    ###
#                #                    #    #      #    #        #    #     #   #
##############    #############    ## #    #      #    #        #    #     #   #
#           #          #              #    #      #    #    ### #    #         #
#           #                         #    #      #    #        #    #         #
#                                     #    #      #             #    #         #
#                                     #    #      #             #    #         #
#                                     #    #      #             #    #     #   #
######################################     #      #             #    #     #   #
#   #             #       #    #           #      #             #    #     #   #
#   #             #       #    #           #                    #    #     #   #
#   #             #       #    #           #   ################ #    #     #   #
#   #     #       #       #    #    #      #    #       #       #    #     #   #
#   #     #       #       #    #    #      #    #               #    #     #   #
#   #     #       #       #    #    ##     #    #               #    #     #   #
#         #       #       #    #    #      #    #               #    #     #   #
#         #       #       #    #    #      #             ####   #    #     #   #
#         #       #       #    #    #      #            #       #          #   #
#         #       #       #    #    #      #     ####   #       #          #   #
#   #     #       #       #    #    #      #            #       #          #   #
#   #     #       #       #    #    #      #    #       #       #          #   #
#   #     #       #       #    #                #       #       #    #     #   #
#   #     #               #    #    #######     #               #    #     #   #
#   #     #               #    #     #          ###########     #    #     #   #
#   #     #               #    #     #          #               #    #     #   #
#   #     #               #    #     #     #    #               #    #     #   #
#   #     #       #       #    #     #     #    #               #    #     #   #
#   #     #       #       #          #     #                         #     #   #
#   #     #       #   ### #          #     ########    ############# #     #   #
#   #     #       #       #          #     #                    #    #     #   #
#   #     #       #       #          #     #                         #     #   #
#   #     #       #       #    #     #     #                         #     #   #
#   #     #       #       #    #     ###   #                         #     #   #
#   #     ##      #       #    #     #     ###############    ##     #     #   #
#   #     #       #       #    #     #     #                    #    #     #   #
#   #     #       #       #    #     #     #                    #    #     #   #
#   #     #       #       #    #     #     #                    #    #     #   #
#   #     #       #       #    #     #     #                    #    #     #   #
#    #### #       #       #    #     #     #                                   #
#   #     #       #       #    #     #     ##########    #######################
#   #     #       #       #    #     #     #                  #          #     #
#   #     #               #    #     #     #                  #          #     #
#   #     ##########      #    #     #     #                  #          #     #
#   #     #      #        #    #     #     #                  #          #     #
#   #     #      #        #    #     #     #    #                              #
#   #     #      #        #    #     #     #    #                              #
#   #     #      #        #    #           #    #                              #
#   #     ##     ######   #    #           #    #   #####################      #
#   #     #      #        #    #           #    #                        #     #
#         #               #    #           #    #                        #     #
#         #               #    #     #     #    #                        #     #
#                         #    #     #     #    #      #                 #     #
####    ################# #    #     #     #           #                 #     #
#             #      #    #    #     #     ############    ############# #     #
#             #      #    #                #             #     #         #     #
#                         ######    ###### #             #     #         #     #
#                         #          #*    #             #               #     #
#                         #          #     #    #        #               #     #
#                         #                #    #   #### #   ##     #### #     #
##########    ###### #    #                #    #        #               #     #
#           #        #    #                #    #              #         #     #
#           #        #    #     #          #    #              #         #     #
#           #        #    #     #    #     #    #                        #     #
#           #        #    ###   #    #     ##    ########     ########## #   ###
#####    ## #   #### #    #     #    #     #     #       #       #       #     #
#      #    #        #    #     #    #     #     #       #       #       #     #
#      #    #        #          ###    ### #             #       #       #     #
#      #    #        #          #          #             #       #       #     #
#                    #          #          #             #               #     #
#                    #          #          #             #               #     #
################################################################################
