80 80
################################################################################
#   #          #                                            #    #       #     #
#   #          #                                            #    #       #     #
#   #          #                                            #    #       #     #
#       ###### #                                    #    ## #    #       #     #
#              #                    #               #       #    #       #     #
#              #                    #               #       #    #       #     #
#              #                                    #       #    #       #     #
#   #    #     ################    ################ #       #    #       #     #
#   #    #     #                                    #            #       #     #
#   #    #                                          #            #       #     #
#   #                                               #            #       #     #
##    #########                                     #            #       #     #
#               ####################################    ### #    #       #     #
#              #                                            #    #       #   ###
#              #                                            #    #       #     #
#              #                                            #    #   ### #     #
#                                                           #    #       #     #
##############################################    ######### #    #       #     #
#     #         #     #                 #      #     #      #    #             #
#     #         #     #                 #      #     #      #    #             #
#     #         #     #                 #      #     #      #    #             #
#     #         #     #                 #      #            #    #             #
#     #         #     #        #        #      #            #    #             #
#     #         #     #        #        #      #            #    ############  #
#     #         #     #        #        #      #            #    #     #       #
#     #         #     #                 ###    #     #      #    #     #       #
#     #                ###    ##########       #     #      #    #     #       #
#     #                                        #     #      #    #             #
#     #                                        #     #      #    #             #
#     #                                        #     #      #    #             #
#     #         #     #                 #      ###   #      #    #             #
#     #         #     ##############    ###### #     #      #    #     #       #
#     #         #     #    #                   #     #      #    #     #       #
#     #         #     #    #                   #     #      #    #     #       #
#     #         #     #                        #     #      #    #     #       #
#     #         #     #                              #      #    #     #       #
#     #         #     #          #    #              #      #    #     #       #
#     #         #     ###    ### #    #                     #    #     #       #
#     #         #     #          #####    ##### #########   #    #     #       #
#     #         #     #          #             #            #    #     #       #
#     ####      #     #          #             #            #    #     #       #
#     #         #     #          #             #            #    #     #       #
#     #         #     #          #             #            #    #     #       #
#               #     #                                     #    #     #       #
#                     ###################    ############## #    #     #       #
#         ########### #                         #      #    #    #     #       #
#                #    #                         #           #    #     #       #
#     #               #                         #           #    #     #       #
#     #               #                 #       #           #    #     #       #
#     #               #                 #                   #          #       #
#                     #                                     #          #       #
#  ################## #########    ############# ###    ### #          #       #
#      #              #                                     #          #       #
#      #              #                         #           #    #     #       #
#                     #                         #           #    #     #       #
#                     #                         #     #     #    #     #       #
#                     #     #                   #     #     #    #     #       #
#                     #     #                   #     #     #    #     #       #
#                     #     #                   #     #     #    #     #       #
#                     #                                          #     #       #
####################    ######################################## #     #       #
#                                      #                   #     #     #       #
#                                      #                   #     #     #       #
#                                      #                   #     #     #       #
#                                      #                   #     #     #       #
#############    ##################### #######    ######## #     #     #       #
#                           #          #          #              #     #       #
#                           #          #                         #     #       #
#                                      #                         #     #    ####
#   #                                  #                         #     #       #
#   #    #                             #                   #     #     #       #
#   #    #                             #                   #     #     #       #
#        ####    ##################### ####################      #     #       #
#####    #                        #    #                         #     #       #
#        #                        #    #                         #     #       #
#        #                        #    #                         #     # *     #
#        #                                  #                    #     #       #
#        #                                  #                    #     #       #
################################################################################
