80 80
################################################################################
#     #    #                                                            #      #
#     #    #                                                            #      #
#     #    #                                                            #      #
#     #    #                                                            #      #
#     #    #   ######################################################## #      #
#     #    #      #                   #       #           #             #      #
#     #    #      #                   #       #           #             #      #
#     #    #      #                           #                         #      #
#     #    #      #                           #                         #      #
#     #    #      #                           #    ####### ##    ###### #      #
#     #    #       ################    ###### #      #                  #      #
#     #    #           #       #              #      #    #                    #
#          #   ###     #       #              #      #    #                    #
#          #           #                      #           #       #            #
#          #      #    #                 #    #           #       #            #
#          #      #    #                 #    #                         #      #
#     #    #      #    #####             #     ######################   #      #
#     #    #      #    #       #         #                              #      #
#     #    #      #    #       #######    ####                          #      #
#     #    #      #            #     #                                  #      #
#     #    #      #            #     #        #               #         #      #
#     #    #      #            #     #        ###########     #    #    #      #
#     #    #      #######      #     #        #               #    #### #      #
#     #    #      #            #   ## ####    #               #         #      #
#     #    #      #            #              #               #         #      #
#     #    #      #            #              #               #         #      #
#     #    #      #            #              #               #         #      #
#     #    #      #            #                                        #      #
#     #    #      #############    #################################### #      #
#     #    #      #                                                     #      #
###   #    #      #                                                     #      #
#     #    #      #                                                     #      #
#     #    #      #                                                     #      #
#     #    #      #########                                             #      #
#     #    #      #      #     ###    ################################# #    ###
#     #    #      #      #     #                                        #      #
#          #      #            #                                        #      #
#  ####### #      #            #                                        #      #
#     #    #      #            #                                        #      #
#     #    #                                                                   #
#     #    ##################################################    ###############
#     #    #        #             #         #     #                     #      #
#     #    #        #             #         #                           #      #
#     #    #        #             #         #                           #      #
#     #    #        #                       #                #    #     #      #
#     #    #        #                       ###    ######    #    #     #      #
#     #    #        #                       #     #          #          #      #
#     #    #        ##############  * ##### #     #          ########   #      #
#     #    #        #      #                #     #          #    #     #      #
#     #    #        #                       #     #          #    #     #      #
#     #    #####    #                       ######    ###### #    #            #
#     #    #        #                                        #    #            #
#     #    #        #                                        #    #            #
#          #        #                                        #    #          ###
#          #        #                                        #          #      #
#          #        ############################    ######## #          #      #
#          #        #                               #        #          #      #
##    #    #        #                               #        #          #      #
#     #    #        #                               #        #          #      #
#     #    #        #                               #        ########    #######
#     #    #        #                                        #                 #
#     #    #        #                                        #                 #
#     #    #        #                                        #                 #
#     #    #        #                                                          #
#     #    #        ###########################################    #############
#     #    #        #         #      #               #                         #
#     #             #                #                                         #
#     #             #                #                                         #
#     #             #                #                                         #
#     #             #                #                                         #
#     #    #        #         #      #               #                         #
#     #    #        ######    ###### #               #                         #
#     #    #        #         #      #                                         #
#     #    #        #         #      #######################    ################
#     #    #        #         #      #                                         #
#     #    #                         #                                         #
#     #    #                                                                   #
#     #    #                                             #                     #
################################################################################
