80 80
################################################################################
#   #                #         #                #    #          #        #     #
#   #                #         #                #    #          #        #     #
#   #                #         #                #    #          #        #     #
#   #                #         ###########      #    #          #        #     #
#   #                          #                #    #    ##### #        #     #
#   #                          #                #    #     #    #        #     #
#   #                          #                #    #     #    #              #
#   #######################    #        #            #     #    #              #
#           #                           #            #     #    #              #
#           #                           #            #     #    #            ###
#                                                    #     #    #        #     #
#                                    ############### #     #             #     #
#                              #       #             #     #             #     #
#######################    ### #                     #     #             #     #
#                              #                     #     #        #### #     #
#                              #                     #     #    #        #     #
#                              #                     #     #    #        #     #
#                              #                     #     #    #        #     #
#                                                    #     #    #        #     #
####    ############################################ #     #    #        #     #
#        #    #                                      ##    #    #        #     #
#        #    #                                      #     #    #        #     #
#        #    #                                      #     #    #        #     #
#        #    #         #                            #     #    #        #     #
#        #    #         #                            #          #######    #####
#   #### #    #         #                            #          #     #    #   #
#             #                                      #          #     #    #   #
#             #############    ##################### #          #     #    #   #
#             #      #             #      #    #     #     #    #     #    #   #
#             #                    #      #    #     #     #    #     #    #   #
####    ##### #                    #      #    #     #     #    #     #        #
#             #                    #           #     #     #    #     #        #
#             #                    #           #     #     #    #     #        #
#             ###############      #           #     #     #    #     #        #
#       #     #      #             #           #     #     #    #     #   ######
#       #     #      #                   ##### #     #     #    #     #    #   #
#       #     #                                #     #     #    #     #    #   #
#       #     #                                #     #     #    #     #        #
#       #     #            ####                #     #     #    #     #        #
#       #     #            #       #           #     #     #    #     #        #
#       #     ####    #### #       #      #    #           #    #              #
#       #     #            #       #   ## #    #           #    #          #   #
#       #     #            #       #      #    #           #    #          #   #
#       #     #            #       #      #    #           #    #          #   #
#  #### #     #            #       #      #    #     #     #    #    ##    #   #
#       #     #      #     #       #      #    #     #     #    #     #    #   #
#       #     #      #     #       #      #    #     #     #    #     #    #   #
#       #     #      #                         #     #     #    #     #    #   #
#       #     #######    ##################### #     #     #    #     #    #   #
#       #     #    #    #      #          #    #     #     #    #     #    #   #
#       #     #         #      #               #  *  #     #    #     #    #   #
#       #     #                #               #     #     #    #     #    #   #
#       #     #                #               #     #     #    #     #    #   #
#       #     #                #               #     #     #    #     #    #   #
#       #     #                #          #    #     #     #                   #
#       #     #         #      #          #    #     ######    #################
#       #     #######   #      #               #     #     #    #      #       #
#       #     #    #    #      #############   #     #     #    #      #       #
#       #     #    #    #                      #     #     #    #      #       #
#       #     #    #    #                      #     #     #    #      #       #
#       #     #    #    #                      #     ##    #    ##     #       #
#       #     #    #    #                      #     #     #           #       #
#       #     #    #    #######    ########### #     #                 ###    ##
#       #     #    #    #    #       #    #    #     #                 #       #
#       #     #    #    #    #       #         #     #                 #       #
#       #     #    #    #                      #     #          ###### #       #
#       #     #    #    #                      #     #     #           #       #
#       #          #    #                      #     #     #           #       #
#       #          #    #                 #    #     #     #           #       #
#       #          #    ########    ##    #          #                 #       #
#       #          #    #      #     #    #          #   ############# #       #
#       #     #         #      #     #    #          #     #           #       #
#       #     #         #      #     #    #          #     #           #       #
#       #     #         #            #    #    #     #                 #       #
#       #     #         #            ###    ## #     #                 #       #
#       #     #    #    #            #         #     #                 #       #
#       #     #    #    #            #         #     #                         #
#       #     #    #    #      #     #         #     #     #                   #
################################################################################
