80 80
################################################################################
#   #      #                                               #                   #
#   #      #                                               #                   #
#   #      #     #                                         #                   #
#   #      #     #######    ###############################    #################
#   ##     #     #                                                             #
#   #      #     #                                                             #
#          #     #                                                             #
#          #     #                                                             #
#          #     ###################    ########################################
#          #     #                                                       #     #
#   #      #     #                                                       #     #
#   #      #     #                                                       #     #
#   #      #     #                                                       #     #
#   #      #     #                                                             #
#   #      #     #                                                             #
#   #      #     #                                                             #
#          #                                                                   #
#####      ########################    #########################################
#   #      #     #        #            #                                 #     #
#   #      #     #        #            #                                 #     #
#   #      #     #        #            #                                 #     #
#   #      #              #            #                                       #
#   #      #              #    #       #                                       #
#   #      #              #    #       ###############    ############### ###  #
#   #      #########      #    #       #                                       #
#   #      #     #        #    #       #                                 #     #
#   #      #     #        #    #       #                                 #     #
#   #      #     #        #    #       #                                       #
#   #      #     #             #       ########################    #############
#   #      #     #             #       #       #              #                #
#   #      #     #             #       #       #                               #
#   #      #     #             ##      #       #                               #
#   #      #     #        #    #       #       #                               #
#   #      #     #        #    #       #       #                               #
#   #      #     #        #    #       #       #              #                #
#   #      #     #        #    #       #       #              #                #
#   #      #     #        #            #       #              #                #
#   #      #     #        ######    ## #####   ###############    ##############
#   #      #     #        #       #    #       #        #     #       #        #
#   #      #     #        #       #    #       #        #     #       #        #
#   #      #     #        #            #       #        #     #       #        #
#   #      #     #        #            #       #        #     #       #        #
#   #      #     #        #            #       #        #     #       #        #
#   #      #     #        #            #       #        #     #    ## #        #
#   #      #     #        #       #    #       #        #     #       #    #####
#   #      #     #        #       #    #       #        #     #       #        #
#   #      #     #        #       #    #       #        #     #                #
#   #   ## #     #        #       #    #       #        #     #                #
#   #      #     #        #       #    #       ####     #     #                #
#   #      #     #        #       #    #       #        #     #                #
#   #      #     #    ### #       #    #       #        #     ##############   #
#   #      #     #        #       #    #       #        #     #    #     #     #
#   #      #     #        #       #    #       #        #     #          #     #
#   #      ##    #        #       #    #                #     #          #     #
#   #      #     #        #       #    #                #     #          #     #
#   #      #     #        #       #    #                #     #          #     #
#   #      #     #        #       #    #                #                #     #
#   #      #     #        #    ## #    #       #        #           #### #     #
#   #            #        #       #    #       #        #           #    #     #
#   #            #        #       #    #       #        #           #    #     #
#   #                     #       #    #       #        #     #     #    #     #
#   #                     #       #    #       #        #     #     #    #     #
#   #      #                           #       #        #     #     #    #     #
#   #      ###########    #############        #        #     #     #    #     #
#   #      #     #    #       #                #        #     #     #    #     #
#          #     #    #       #                #        #     #     #          #
#          #          #       #                #        #     #                #
#          #          #       #        #       #        #     #                #
#          #          #####   #        #       #              ##              ##
#   #      #    ######        #        #       #              #          #     #
#   #      #                  #   #### #       #              #     #    #     #
#   #      #                  #        #       #              #     #    #     #
#   #      #                           #       #        #                #     #
#   #      #                           #       #        #################    ###
#   #      ###########    ####         #       #        #                      #
#   #      #                           #       #        #                      #
#   #      #                  #        #       #        #     *                #
#   #      #                  #        #       #        #              #       #
################################################################################
