80 80
################################################################################
#                                #                                   #     #   #
#                                                                    #     #   #
#                                                                    #     #   #
#                                                                    #     #   #
#######################    ###### ###########################    ####      #   #
#                                #                   #                     #   #
#                                #                   #                     #   #
#                                #                   #                     #   #
#                           #    #                   #               #     #   #
####    ################### #    #   ################ ####    ###### #     #   #
#                           #    #      #                 #          #     #   #
#                           #    #      #                 #          #     #   #
#                           #    #                                   #     #   #
#                           #    #                   #               #     #   #
#                           #    #                   #               #     #   #
#                                                    #               #     #   #
####################################################    ############ #     #   #
#     #     #    #                                                   #     #   #
#     #     #    #                                                   #     #   #
#     #     #    #                                                   #     #   #
#     #     #    #                                                   #     #   #
#     #    ##    ################################    ############### #     #   #
#     #          #            #             #      #     #     #     #     #   #
#     #          #            #                    #     #     #     #     #   #
#     #          #            #                    #                 #     #   #
#                #            #                    #                 #     #   #
#           #    ##########   ######    ####       #      ##         #     #   #
#           #    #       #    #        #    #      #                 #     #   #
#      ###    ## #       #    #        #    #      #     #     #     #     #   #
#     #          #       #    #        #    ####   #     #     #     #     #   #
###   #          #            #        #    #      #     #     #     #     #   #
#     #          #                          #      #     ######      #     #   #
#     #     #    #                          #      ##    #    #      #     #   #
#     #     #    #                                 #     #    #      #     #   #
#     #     #    #       #     ###############     #     #    #      #     #   #
#                #####   #    #            #       #     #    #      ##    #   #
#  ############# #       #    #            #       #     #    ###    #     #   #
#   #       #    #       #    #                    #     #    #      #     #   #
#   #       #    #       #    #                    #     #    #      #     #   #
#   #       #    #                                 #     #           #     #   #
#   #       #    #    ############################ #     #           #     #   #
#           #    #    #    #            #     #    #     #           #     #   #
#           #    #    #                 #     #    #                 #     #   #
#           #    #    #                 #     #    ##    ########### #     #   #
#           #    #    #                       #    #    #     #      #         #
#   #       #    #    #            #          #    #    #            #         #
#   #       #    #    #    #       #          #    #    #            #         #
#    ###### #    #    #    #       #          #    #    #            #         #
#      #         #    #    #       #        * #    #    #            #     #   #
#      #         #    #    #       #   #######     #    ###   #      #     #   #
#      #         #    #    ####    #               #    #     #      #     #   #
#      #         #    #    #       #               #    #     ###    #     #   #
#      #    #    #    #    #       #               #    #     #      #     #   #
#      #    #    #    #    #       #               #    #     #      #     #   #
#      #    #    #    #    #       #   ########### #    #     #      #     #   #
#      #    #    #    #    #       #        #      #    #            #     #   #
#      #    #    #    #    #       #        #      #    #   ######## #     #   #
#      #    #    #         #       #        #      #    #     #      #     #   #
#      #    #    #         #       #        #      #    #     #      #     #   #
#      #    #    #         #       #        #      #          #      #     #   #
#      #    #    ###    ## #       #        #      #          #      #     #   #
#           #    #    #    #       #        #      #          #      #         #
#           #    #    #    #       #        #      #          #      #    ######
##          #    #    #    #       #        #      #    #     #      #    #    #
#           #              #       #        ####   #    #     #      #    #    #
#      #    #              #       #        #      #    #     ####   #    #    #
#      #    #                      #        #      #    ##    #      #    #    #
#      #    #     ###########      #        #      #    #     #      #    #    #
#      #    #    #          #      #        #      #    #            #         #
#      #    #    #          #      #        #      #    #            #         #
#      #    #    #          #      #####    #      #    #            #         #
#      #    #    #    #     #      #               #    #            #         #
#      #    #    #    #     #      #               #    #     #      #    #    #
#      #    #    #####    ## ##    #               #    #     #      #    #    #
#      #    #    #                 #               #    #     #      #    #    #
#      #    #    #                 #        #      #    #     #      #    #    #
#      #    #    #                 #        #           #     #      #    #    #
#      #    #    #    #     #      #        #           #     #      #    #    #
################################################################################
