80 80
################################################################################
#         #    #             #    #          #              #    #    #        #
#         #    #             #               #              #         #        #
#         #    #             #                              #         #        #
#         #    #             #                              #         #   ######
#######   #    #        #    #    ###########     ######### ###    ## #        #
#    #    #    #####    #    #                              #         #        #
#         #    #        #                    #              #         #        #
#         #    #        #                    #              #                  #
#         #    #        #                                   #              #   #
#         #    #        #     ##################    ########     #         #   #
#    #    #    #        #    #              #                    #             #
#    #    #    #        #    #              #                ##    #############
#    #    #    ######    ### #                                       #         #
#    #    #    #     #       #                              #                  #
#    #    #    #     #       #                              #                  #
#    #    #    #     #       #                              #                  #
#    #    #    #     #       #                              #                  #
#    #    #    #     #       #                                                 #
#    #    #    #     #       ############################################    ###
#    #    #    #     #       #            #                        #    #      #
#    #    #    #     #       #                                     #           #
#    #    #    #     #       #                                     #           #
#    #    #    #     #       #                                     #           #
#    #    #    #     #       #                                     #           #
#    #    #    #     ##      ###################################   #           #
#    #    #    #             #        #                            #########   #
#    #    #    #             #                                     #           #
#    #    #    #             #                                                 #
#    #    #    #             #                                                 #
#    #    #    #     #       #                                                 #
#    #    #    #     #       #        #                                 #      #
#    #    #    #     #     * #        #                                 #      #
#    #    #    #                                                               #
#    #    #    #######    ######################################################
#    #    #    #                                                 #             #
#    #    #    #                                                 #             #
#    #    #    #                                                 #             #
#    #    #                                                      #             #
#    #    #     #######################################    ##### #             #
#    #    #                                                      ##    #########
#    #    #                                                                    #
#    #    #    #                                                               #
#    #    #    #                                                               #
#    #    #                                                                    #
#    #    #############################    #####################################
#    #    #                                            #      #       #    #   #
#    #    #                                            #      #       #    #   #
#    #    #                                            #      #       #    #   #
#    #    #             #                              #      #       #    #   #
#    #    #             #                              #      ##      #    #   #
#    #    #                                            #      #       #    #   #
#    #    ####################################    #### #      #       #    #   #
#    #    #      #    #         #          #           #      #            #   #
#    #    #           #         #          #           #      #            #   #
#    #    #           #         #          #           #      #            #   #
#    #    #           #         #          #                               #   #
#    #    #           #         #                                     #        #
#    #    #            ###      #                          ###        #        #
#    #    #                     #                                     #        #
#    #    ##    ######          #                      #      #       #        #
#    #           #              ##    ################ #      #       #    #   #
#    #           #    #         #                #     #      #       #    #   #
#    #           #    #         #                #     #      #       #    #   #
#    #                #         #                #     #              #    #   #
#    #    #           #         #                #     ############   #    #   #
#    #    #   ###     #         #        #       #     #         #    #    #   #
#    #    #           #         #        #       #     #         #    #    #   #
#    #    #      #    #                  #       #     #         #    #####    #
#    #    #      #    #                          #     #         #    #        #
#    #    #                           ########## #     #              #        #
#    #    ##    ################                 #     #              #        #
#    #    #              #      #                ###   #                       #
#    #    #              #      #                      #    ####################
#    #    #              #      #                      #            #          #
#    #    #                     ########   #           #            #          #
#    #    #                     #          #           #            #          #
#    #    #                     #          #     #     #                       #
#    #    #                     #          #     #     #                       #
################################################################################
