80 80
################################################################################
#                                       #         #    #       #        #      #
#                                       #         #    #       #        #      #
#                                       #              #       #        #      #
#                #                      #              #       #        #      #
#                #                      #                      #        #      #
#                                       #                      #        #      #
#############################    ###### #         #            #        #      #
#   #                    #      #       #         #            #        #      #
#   #                    #      #       #         #    #       #        #      #
#   #                           #       ####      #    #       #        #      #
#   #     #                     #       #         #    #       #        #      #
#   #     #                     #       #         #    #       #        #####  #
#   #     ##########    ####### #       #         #    #       #        #      #
#   #     #          #          #       #         #    #       #        #      #
#   #     #          #          #       #         #    #       #        #      #
#         #          #          #       #         #    #       #        #      #
#         #                     #       #         #    #       #        #      #
#         #     #               #       #         #    #       ##    ## #      #
#         #     #               #       #         #    ####             #      #
#         #     #               #       #         #    #                #      #
####      #     #########    ###                  #    #                #      #
#         #     #                                 #    #                #      #
#         #     #                                 #    #       #        #      #
#         #     #                                 #    #       #               #
#         #     #               #       #              #       #               #
#                               #       #   ########## #       #               #
############    ############### #       #    #         #       #               #
#    #     #                    #       #    #         #       #   #############
#    #     #                    #       #    #         #       #        #      #
#    #     #                    #       #    #         #       #        #      #
#    #           #              #       #    #    #### #       #        #      #
#    #           #####    ##### #       #    #    #    #       #        #      #
#    #           #              #       #    #    #    #       #               #
#    ######      #              #       #    #         #       #               #
#    #           #              #       #              #       #               #
#    #           #              #       #              #       #               #
#    #           #              #       #              ######    ###############
#    #           #              #       #         #    #    #                  #
#    ############    ########## #       #    #    #    #    #                  #
#    #    #                #    #       #    #    #    #    #                  #
#    #    #                #    #       #    #    #    #    #                  #
#    #    #                #    #       #    #    #    #                       #
#    #    #                #    #       #    #    #    #                       #
#    #    #                #    #       #              #                 *     #
#    #    #        #       #    #       #############    #######################
#    #    #        #       #    #       #         #    #     #     #           #
#    #    #                #    #       #              #     #     #           #
#    #    #    ########### #    #       #              #     #     #           #
#    #                #    #    #       #              #           #     #     #
#    #                #    #    #       ###    ###     #                 #     #
#    #                #    #    #       #         #    #                 #     #
#    #          #     #    #    #       #         #    #                 #     #
#    #    #     #     #    #    #       #         #    #     #           #     #
#    #    #           #    #    #       #              #     #     #     #     #
#    #    #######          #    #       ###    ####### #     ##    #     #     #
#         #                #    #       #      #       #     #     #     #     #
#         #                #    #       #      #       #     #     #     #     #
#         #                #    #       #      #       #     #     #     #     #
#                          #    #       #      #       #     #     #     #     #
#    #    ################ #    #       #      #       #     #     #     #     #
#    #                #    #    #       #      #       ###    #### #     #   ###
#    #                #    #    #       #      #       #           #     #     #
#    #                #    #    #       ####   #    ## #           #     #     #
#    #                #    #    #       #      #                   #     #     #
#    #                #    #    #       #      #              #    #     #     #
#    #######    ##### #    #    #       #                     #    #     #     #
#    #     #          #    #    #       #                     #    #     #     #
#    #     #          #    #    #       #                     #    #     #     #
#    #                #    #    #       #                     #    #     #     #
#    #                #    #    #       ######################     #     #     #
#    #                     #    #       #       #                  #     #     #
#    ##        #######     #    #       #                          #     #     #
#    #     #    #          #    #       #                          #           #
#    #     #    #               #       #                          #########   #
#    #     #          #         #####   ##    ## ###    ########## #           #
#    #     #          #         #       #       #                  #           #
#    #     #          #         #       #       #                  #           #
#    #     #          #    #    #       #       #                  #           #
################################################################################
