80 80
################################################################################
#       #    #       #    #              #        #                   #        #
#       #    #       #    #                                           #        #
#       #    #       #    #                                           #        #
#       #    ####    #    #                                           #        #
#       #    #       #    ###################      ##########    #### #        #
#       #    #       #    #                       #                   #        #
#       #    #       #    #                       #                   #        #
#            #       #    #                       #                   #        #
#            #       #    #                                           #        #
#            #       #    #############    ########################## #        #
#            #       #    #       #        #    #                     #        #
#       #    #       #    #       #        #    #                     #        #
#       #    #       #    #       #        #    #                     #        #
#    ## #    #       #    #       #        #    #                     #        #
#       #    #            #       #        #    #        #            #        #
#       #    #            #       #        #    #        #            #        #
#       #    #            #       #        #    #        #            #        #
#       #    #            #       #        #    #        #            #        #
#       #    #       #    #       #        #    #######    ########## #        #
#       #            #    #       #        #    #     #     #    #    #        #
#       #            #    #       #        #    #     #     #    #    #        #
#       #            #    #       ###      #    #     #          #    #        #
#       #            #    #       #        #    #     #               #        #
#       #    #       #    #       #        #    #                     #        #
#       #    #       #    #       #        #                          #        #
#       #    #            #       #        #                #         #        #
#       #    #########    #       #        #                ###    ## #        #
#       #    #     #      #       #        #     ######     #         #        #
#       #    #     #      #       #        #    #           #         #        #
#       #    #     #              #        #    #           #         #        #
#       #    #     #              #        #    #           #                  #
#       #    #     #              #        #                                   #
######    ## #     ##             #        ######    #################         #
#            #     #      #       #        #    #             #                #
#            #     #      #       #        #                  #       #        #
#            #            #       #        #                  #       ####    ##
#            #            #       #        #                  #       #        #
#                         #       #        #     ##########   #       #        #
################    ##### #       #        # *  #             #       #        #
#   #        #     #      ##      #        #    #                     #        #
#   #        #     #      #       #        #    #                     #        #
#   #        #     #      #       #        #                          #        #
#   #        #     #      #       #        ########    #######        #        #
#   ###      #     #      #       #        #     #      #     #       #        #
#   #              #      #       #        #     #      #     #       #        #
#   #              #      #       #        #            #     #       #        #
#   #              #      #       #        #                  #       #        #
#   #              #      #       #        #                  #       #        #
#                  #      #       #        #                  #       #        #
#                  #      #       #        #    ##            #       #        #
#    ###########   #      #       #        #     #      #     #       #        #
#                  #      #                      #   ## #     #       #        #
#   #              #      #                      #      #     #       #        #
#   #              #      #                      #      #     ####    #        #
#   #              #      #                      #      #     #       #        #
#   #              #      ##########    ## #            #     #       #        #
##    ############ #      #                ##    ###### #     #       #        #
#    #      #      #      #                #            #     #       #        #
#    #             #      #                #            #     #       #        #
#                  #      #           #    #            #     #       #        #
#                  #      #           #    #            #     #       #        #
#                  #      #                             #                      #
#           #      #      #############################    #####################
#           #      #      #                                   #        #       #
#           #      #      #                                   #        #       #
#   ####### #      #      #                                   #        #       #
#      #    #      #      #                                   #                #
#      #    #             #                         #         #                #
#      #    #             #                         #         #                #
#      #    #    ##       #                         #         #                #
#      #    #             #                                   #        #       #
####   #    #      #      ############################    ### #        #       #
#      #    #      #      #           #                       ######    ########
#           #      #      #           #                                   #    #
#           #      #      #           #                                   #    #
#           #      #      #                                               #    #
#           #      #      #                                                    #
#      #    #      #      #                                   #                #
################################################################################
