80 80
################################################################################
#   #                                         #      #                         #
#   #                                         #      #                         #
#            #                                #      #                         #
#            #    #                                  #                         #
#            #    #                                  #                         #
#         ## #    #                                  #####    ##################
#   #        #    #                                  #       #     #      #    #
#   #        #    ##############################     #       #     #      #    #
#   #        #    #     #                     #      #       #     #      #    #
#   #        #    #     #                            #       #     #      #    #
#   #        #    #                                  #       #     #      #    #
#   #        #    #                                  #       #     #   ## #    #
#   #######    ## #          #####    ########       #       #     #      #    #
#   #        #    ######     #       #        #      #       #     #      #    #
#   #        #    #    #     #       #        #      #       #     #      #    #
#   #        #    #    #     #       #        #      #       #     #      #    #
#   #             #    #     #       #        #      #       #     #      #    #
#   #             #    #     #    ## ######   #      #       #     #      #    #
#   #             #          #       #        #      #       #     #      #    #
#   #             #          #                #      #       #     #      #    #
#   #             #          #                #      #       #     #      ##   #
#                 #                           #   ## #       #     #      #    #
###############   ##    ##################### #      #       #     #      #    #
#      #          #     #                     #      #       #     #           #
#      #          #                           #      #       #     #           #
#      #          #                           #      #       #                 #
#                 #                           #      #       #                 #
#                 #                           #      #       #                 #
#                                                    #       #      ########   #
##########    ###################################### #       #     #    #      #
#       #                  #      #       #          #       #     #    #      #
#       #                  #      #       #          #       #     #    #      #
#       #                  #      #       #          #       #     #    #      #
#       #          #       #      #       #          #       #     #    #      #
####    #     #    #       #      #       ##    #### #             #    #      #
#       #     #    #       #      #       #     #    #             #    #      #
#             #####    ### #      #       #     #    #        ##   #    #      #
#             #    #       #      #       #     #    ####          #    #      #
#             #    #       #      #       #     #    #       #     #    #      #
#             #    #       #      #       #     #    #       #     #    #      #
#       #     #    #       #      #       #     #    #       #     #    #      #
#       #     #    #       #      #       #     #    #       #     #    #      #
#       #     #    #       #      #       #     #    #       #     #    #      #
#       #     #    #       #      #       #     #            #     #    #      #
#       #     #            #              #     #            #     #    #      #
#       #     #            #              #     #            #     #    #      #
#       #     #            #              #     #            #     #    #      #
#       #     #            #          ### #     #    #       #     #    #      #
#       #     #    #       ##    ##       #     #    #       #     #    #      #
#       #     #    #       #      #       #     #    #       #     #    #      #
#             #    #       #      #       #     #    #       #     #    #      #
####    ##### #    #       #      #       #     #    #       #     #    #      #
#     #       #    #####   #              #     #    #       #     #           #
#     #       #    #       #   ########## #     #    #       #     #           #
#     #       #    #       #              #     #    #       #     #           #
#     #       #    #                      #     #    #       #     #           #
#     #       #    #                      #     #    #       #     #    #      #
#     #       #    #                      #     # *  #       #     #    #      #
#     #       #    #                      #     #    #             #    #      #
#     #       #####    ################## #     #    #########     #    #      #
#     ####    #        #                  #     #    #      #      #    #      #
#     #       #        #                  #     #    #      #      #    #      #
#     #       #                           #     #    #      #      #    #      #
#     #       #                           #     #    #      #      #    #      #
#             #                           #     #    #      #      #    ##    ##
#             #                           #     #    #      #      #    #      #
#             #                           #     #    #             #    #      #
#                                         #     #    #             #    #      #
#####################################     #          #             #    #      #
#                                         #          #             #    #      #
#                                         #          #      #      #    #      #
#                                                    #      #      #    #      #
#                                               #    #      #      #    #      #
############    ########### #                   #    #      #      #    #      #
#                           #   ##########      #    #      #      #    #      #
#                           #             #     #    #      #      #    #      #
#                           #             #     #    #      #      #    #      #
#                     #     #             #     #    #      #      #    #      #
################################################################################
