80 80
################################################################################
#                                                            #         #       #
#                                                            #         #       #
#                                                            #         #       #
#                                                            #    #    #       #
#############################    ########################### #    #    #       #
#    #       #      #     #     #                            #    #    #       #
#    #       #      #     #     #                            #    #    #       #
#    #       #      #     #     #                            #         #       #
#    #       #      #           #                            #######   #       #
#    #       #      #           #   ######################## #    #    #       #
#    #       #      #           #    #         #             #         #       #
#    #   ### #      #           #              #             #         #       #
#    #       #      #     #     #              #             #         #       #
#    #       #      #######     #              #       #     #         #       #
#    #       #      #      #    #                      #     #    #    #       #
#    #       #      #      #    #                            #    #    #       #
#    #       #      #      #     ##########         ######## #    #    #       #
#    #       #      #      #                         #       #    #    #    ####
#    #       #      #      #                   #     #       #    #    #       #
#    #       #      #      #                   #             #    #    #       #
##   #       #      #           #              #             #    #            #
#    #       #      #           #              #             #    #            #
#    #       #      #                                        #    #            #
#    #       #      ###################################      ###    ############
#    #       #      #     #    #    #                  #     #      #          #
#    #       #      #     #    #    #                  #     #      #          #
#    #       #      #     #    #    #                  #     #      #          #
#    #       #      #     #    #    #                  #     #      #          #
#    #       #      ##    #    #    ##############     #     #      #          #
#    #       #      #     #    #    #     #            #     #      #          #
#    #       #      #     #         #     #            ###   #      #########  #
#    #              #     #         #     #            #     #      #    #     #
#    #              #     #         #     #            #     #      #    #     #
#    #              #     #         #     ###    ##### #     #      #    #     #
#    ########    ## #          #    #     #    #       #     #      #    #     #
#    #     #        #          #    #     #    #       #     #      #    #     #
#    #     #        #          #    #     #    #       #     #      #          #
#    #     #        ########   #    #     #    #       #     #      #          #
#    #     #        #          #    ###        #       #     #      #          #
#    #     #        #          #    #          ####    #     #      #          #
#    #     #        #          #    #          #       #     #      #    #     #
#    #     #        #    #     #    #                  #     #      #    #     #
#    #     #        #    #     #    #     #                  #      #    #     #
#    #     #        #    #     #    #     #                  #      #    #     #
#    #     ####     #    #     #    #     #                  #      #    #     #
#    #     #        #    #     #    #          #             #      #    #     #
#          #        #    #     #    #######    ############# #      #    #     #
#          #        #    #     #    #     #     #    #       #      #    #     #
#          #                        #     #     #    #       #   ## #    #     #
#          #         ############   #     #     #    #       #      #    #     #
#    #     #                 #      #     #     #    #       #      #    #     #
#    #     #                 #            #     #    #       #      #    #     #
#    #              #        #            #     #    #       #      #    #     #
#    #              #        #            ##    #    #       #      #    #     #
#    #              #                ##         #            #      #    #     #
#    #              #               #           #            #      #    #     #
#    #     #        #               #           #     ###    #      #    #     #
#    #     #        #               #           #            #      #    #     #
#    #     #        #        #      #     #     #    #       #      #    #     #
#    #     #        #        #      #     #     #    #       #      #    #     #
#    #     #        #        #      ####    ### #    #       #      #    #     #
#    #     #        #        #      #           #    #       #      #    #     #
#    #     #        #        ###    #           #    #       #      #    #    ##
#    ###   #        #        #      #           #    #       #      #    #     #
#    #     #        #        #      #           #    #       #      #    #     #
#    #     #        #        #      ####   #    #    #       #      #    #     #
#    #     #        #    ### #      #      #    #    #       #      #    #     #
#    #     #        #        #      #      #    #    #       #      #    #     #
#    #     #        #        #      #      #    #            #      #    #     #
#    #              #        #      #      #    #   #########       #    #*    #
##    ############# #        #      #      #    #      #            #    #     #
#       #           #        #      #      #    #      #            #    #     #
#       #           #        #      #      #    #      #            #    #     #
#       #           #        #      #      #    #            #           #     #
#       #           #        #      #      #    #            #           #     #
#                   #        #      #      #                 #           #     #
#                   #        #      #      #                 #           #     #
#                   #        #      #      #           #     #      #    #     #
################################################################################
