80 80
################################################################################
#     #     #       #                                          #     #     #   #
#     #     #       #                                          #     #     #   #
#     #     #       #                                                #     #   #
#     #     #       #                                                #     #   #
#     #     #       #####    ###################### ########         ##    #   #
#     ###   #       #       #                       #                #     #   #
#     #     ##      #       #                       #          ##              #
#     #     #       #                               #          #               #
#     #     #       #                               #     #    #               #
#     #     #       #                                     #    #               #
#     #     #       #####################################      #           #   #
#     #     #       #         #     #        #    #    #       #           #   #
#     #     #       #               #             #            #########   #   #
#     #             #               #             #            #    #      #   #
#     #             #               #             #            #    #      #   #
#     #             #                             #            #    #      #   #
#     #             #                             #    #       #    #      #   #
#     #     #       #   ############ ##    ###### #    #       #           #   #
#     #     #       #                             #    #####   #           #   #
#     #     #       #               #             #    #       #           #   #
#     #     #       #               #             #    #       #           #   #
#     #     #       #                             #    #       #    #      #   #
#     #     #       #########################     #            #    #          #
#     #     #       #                       #     #######      ###    ##########
#     #     #       #                       #     #            #               #
#     #     #       #                       #     #            #               #
#     ###    ###### #                       #     #            #               #
#     #       #     #                                          #               #
#     #       #                                                #     #         #
#     #       #                                                #     #         #
#     #       #                                                                #
#     #       #      #####################################################    ##
#     #       #     #                    #                                #    #
#     #       #     #                    #                                #    #
#     #       #     #                                                     #    #
#     #       #     #                                                     #    #
#     #       #     #                                                     #    #
#     #       #     #                                                     #    #
#     #       ###   #                                                     #    #
#     #       #     ###    ############################################## #    #
#     #       #     #                                   #        #        #    #
#     #       #     #                                   #        #        #    #
#     #       #     #                                   #                 #    #
#     #       #     #                                   #                 #    #
#     #       #     ###########    #################### #                      #
#     #       #     #     #                      #      #                      #
#     #       #     #     #                             #############          #
#     #       #     #     #                             #        #             #
#     #       #     #             #                     #        #        #    #
#     #       #     #             #                              #        #    #
#     #       #     #             #              #               #        #    #
#     #       #     #             ################    ##         ####     #    #
#     ####          #             #          #               ### #        #    #
#     #             ###    ###### #          #          #        #        ##   #
#     #             #             #          #          #        #        #    #
#     #             #             #          #          #        #        #    #
#     #       #     #             #                     #                 #    #
#     #       #     #             #                     #                 #    #
#     #       #     #             #                     #                 #    #
#     #                                                 #                      #
#     #################################################    #####################
#     #    #                                                   #               #
#     #    #                                                   #               #
#          #                                                   #               #
#          #                                                   #               #
#          #####    ###########################################                #
#                      #                                                       #
#     #                #                                           #############
#     #                                                              #         #
#     #                                                        #     #         #
#     #    #                                                   #     #         #
#     #    #                                                   #     #         #
#     #                       *                                #    #########  #
#     ###########################    ######################### #           #   #
#     #          #                                             #               #
#     #          #                                             #               #
#     #                                                        #               #
#     #                                                        #     #         #
################################################################################
