80 80
################################################################################
#             #        #       #         #                                     #
#             #        #       #                                               #
#             #        #       #                                               #
#             #        #       #                                               #
#        #    #        #       #                                               #
#        #    ####     #       #######################################    ######
#        #    #        #       #      #      #                        #    #   #
#        #    #        #       #      #      #                        #    #   #
#        #    #        #       #      #      #                        #    #   #
#        #    #        #       #             #          #             #    #   #
#        #    #        #       #             #          #             #    #   #
#        #    #        #       #             #                        #    #   #
#        #    #        #       #             ##############    ###### #    #   #
#        #    #        #       #      #      #     #             #    #    #   #
#        #    #        #       #      #      #     #             #    #    #   #
#   #### #    #        #       ####   #      #     #             #    #    #   #
#        #    #        #       #      #      #     #             #    #    #   #
#        #    #        #       #      ####   #     #             #    #    #   #
#        #    #        #       #      #      #     #       #          #    #   #
#        #    #        #       #      #      #     #       #          #    #   #
#        #    #        #       #      #      #     #       #          #    #   #
#        #    #        #       #      #      #     #       #          #    #   #
#        #             #       #      #      #     #       #     #    #    #   #
#        #             #       #      #      #     #       #     #    #    #   #
#                      #       #      #      #     #       #     #    #    #   #
###    #######         #       #      #      #     #       #     #    #    #   #
#             #        #       #             #     #       #     #    #    #   #
#             #        #       #   ######### #     #       #     #    #    #   #
#             #        #       #     #       #     #       #     #    #    #   #
#             #        #       #     #       #             #     #    #        #
#                      #       #     #       #             ##    #    #        #
##########    ######## #       #     #       #             #     #    #        #
#   #                  #       #     #       #         ### #     #    #        #
#   #                  #       #             #     #       #     #    #    #   #
#                      #                     #     #       #     #    #    #   #
#            #         #                     #     #       #     #    #    #   #
#            #         #                     #             #     #    #    #   #
#        ### #####     #             #       #########     #     #    #    #   #
#   #        #         #       #     #       #     #       #     #    #    #   #
#   #        #         #       #     #       #             #     #         #   #
#   #        #         ##      #     #       #             #     #         #   #
#   #        #         #       #     #       #             #     #         #   #
#   #        #    #    #       #     #       #             #     #         #   #
#   #        #    #    #       #     #       #     #       #     #    #    #   #
#   #        #    #    #       #     #       #     #       #          #    #   #
#   #                  #       #     #   *   #     #       #######    #    #   #
#   ###    ########### #       #     #       #     #       #     #    #    #   #
#   #             #    #       #     #       #     #       #          #    #   #
#   #             #    #       #     #       #     #    ## #          #    #   #
#   #             #    #       #     #####   #     #       #          #    #   #
#   #             #    #       #     #             #       #          #    #   #
#   #             #            #     #             #       #     #    #    #   #
#   #######    ###             #     #             #       #     #    #    #   #
#   #                          #     #             #       #     #    #    #   #
#   #                          #     #       #     #       #     #    #    #   #
#   #                          #     #       #     #       #     #    #    #   #
#                              #     #                                #    #   #
#####    ##################### ####    ############################## #    #   #
#                    #    #    #            #         #               #    #   #
#                    #    #    #            #         #               #        #
#                         #    #            #         #               #   ######
#                         #    #      #     #         #     #         #    #   #
#       #                      #      #     #          ##   #   ##### #    #   #
#       #                      #            #               #         #    #   #
#       #            #         #   ######## ######          #         #        #
#                    #         #     #      #               #         #        #
#    ############### #    #    #            #         #     #         #        #
#      #             #    #    #                      #               #        #
#      #             #    #    #                      ##########      #    #   #
#      #             #    #    #   ##                 #       #       #    #   #
#      #             #    #    #     #                #       #       #    #   #
#           ######## #    #    #     #      #         #       #       #    #   #
#              #     #    #    #     #      #         #               #    #   #
#   ###        #     #         #                      #               #    #   #
#                    #    #### #######    ########### #               #    #   #
#      #             #         #                      #               #    #   #
#      #             #         #                      #       #       #    #   #
#      #             #         #                      #       #       #    #   #
################################################################################
