80 80
################################################################################
#     #              #                    #                           #        #
#     #              #                    #                           #        #
#     #              #              #     #                                    #
#     #              #              #     #                                    #
#     #####    ##### #                    #                                    #
#     #      #       ###    ############# #                                    #
#     #      #       #                    ###############################    ###
#     #                                   #                 #                  #
#     #                                   #                 #                  #
#     #                                   #                 #                  #
#     #                                   #                 #                  #
#     #                                   #    ############ #     #            #
#     #################    ############## #                       #            #
#     #                        #          #                       #            #
#     #                        #          #                                    #
#     #                        #          #           #           ##############
#     #                        #          ######      ##    #             #    #
#     #                                   #           #     #                  #
#     #                                               #     #                  #
#     #                                               #     #                  #
#     #                                                                        #
#     ########    ##############################################################
#     #    #        #       #    #     #     #              #            #     #
#     #    #        #       #    #     #     #              #            #     #
#     #    #        #       #    #     #     #              #                  #
#     #    #        #       #    #     #     #              #                  #
#     #             #            #     #     ###########    #####    ####     ##
#     #             #            #     #     #                                 #
#     #             #                  #                                 #     #
#     #             #                  #                                 #     #
#     #########     #       #          #                         #       #     #
#     #    #        #       #          #                    #    #       #     #
#     #    #        #       #    #     #                    #            #     #
#     #    #        #       #    #     ###############      ##########    ######
#     #    #        #       #    #     #             #      #    #             #
#     #    #        #       #    #     #             #      #                  #
#     #    #        #       #    #     #             #      #                  #
#     #    #        #       #    #     #                    #                  #
#     #    #        #       #    #     #                    #                  #
#     #    #                #    #     #                    #    #             #
#     #    #                #    #     #                    #    #             #
#     #    #                #    #     #                                       #
#     #    #####     ##     #    #     ###############################    ######
#     #             #       #    #     #                   #    #              #
#     #             #       #          #                   #    #              #
#     #             #       #   ###### #                   #    #              #
#     #                     #     #    #                   #                   #
#     ######    ########### #     #    ######    #### #    #                   #
#     #         #     #     #     #    #              #    #                   #
#     #         #     #     #     #    #              #    #                   #
#     #               #     #     #    #              #    ##########    #######
#     #               #     #     #    #                   #         #         #
#     #               ##    #     #    ###    #############          #         #
#     #               #     #     #    #       #                               #
#     #######   #     #     ###        #       #                               #
#     #    #    #     #     #          #       #            #####          #####
#     #    #    #     #     #          #       #           #                   #
#     #    #    #     #     #                              #         #         #
#     #    #    #     #     #                              #         #         #
#          #    #     #     #                                                  #
#          #    ##    #     ##############################################    ##
#          #    #     #     #                #           #             #       #
#          #    #     #     #                            #             #       #
#     #         #     #     #                            #             #       #
#     #         #           #                      #     #             #       #
#     #         #           ############           #     ##    ####### #####   #
#     #         #           #           #    #     #     #             #       #
#     #    #    #           #           #    ######      #             #       #
#     #    #    #     #     #           #    #     #     #                     #
#     #    #    #     #     #           #    #     #     #                     #
#     #    #    ######      #           #    #           #        *            #
#     #    #    #    #      #                #           ###################   #
#     #    #    #           #                #           #                 #   #
#     #    #    #           #                            #                 #   #
#     #    #    #           #############    ########### #                     #
#     #    #    #           #                            #                     #
#     #    #    #    #      #                                                  #
#     #    #    #    #      #                                                  #
################################################################################
