80 80
################################################################################
#                                                                              #
#                                                                              #
#                                                                      #       #
########################################    ## #                       ###    ##
#            #                         #       #############    ###### #       #
#            #                                 #                  #    #       #
#            #                                 #                  #    #       #
#            #                                 #                  #    #       #
#    ####### #                                 #                  #    #       #
#     #       #####################    ####### ################        #       #
#     #                                        #                       #       #
#                                              #                       #       #
#                                              #                       #       #
#                                                                      #       #
###############################    ################################### #       #
#    #    #    #              #               #    #    #    #    #    #       #
#    #    #    #              #               #    #    #    #    #    #       #
#    #    #    #              #               #    #    #    #    #    #       #
#    #    #    #              #               #    #    #    #    #    #       #
#         #    #        #     ############         #    #    #    #    #       #
#         #    #        #     #                    #    #    #    #    #       #
#         #    #              #                    #    #    #    #    #       #
#         #    ####    ###### #                    #    #    #    #    #       #
#    #    #    #      #       #               #    #    #    #    #    #       #
#    #    #    #      #       #               #    #    #    #    #    #       #
#    #    #    #      #       #############    ### #    #    #    #    #       #
#    #    #    #      #       #          #         #    #    #    #    #       #
#    #    #        ## ####    #          #         #    #    #    #    #       #
#    #    #                              #              #    #         #       #
#    #    #                              #              #    #         #       #
#    #                         ####      #######             #         #       #
#    #         #                         #                   #         #       #
#    #         #      #       #                    #         #    #    #       #
#    #         #      #       #                    #         #    #    #       #
#    #         #                                   #    #    ##    ### #       #
#    ###    ## #   ############################### #    #    #         #       #
#    #         #                                   #    #    #         #       #
#    #         #                                   #         #         #       #
#    #         #                                   #   ##### #         #       #
#    #         #                                   #    #    #         #       #
#    #                                             #    #    #    #    #       #
#    #####################    #################### #    #    #    #    #       #
#    #     #       #         #             #       #    #    #    #    #       #
#    #     #       #         #             #       #    #    #    #    #       #
#    #             #         #             #       #    #    #    #    #       #
#    #             #         #             #       #    #         #    #       #
#    ###    ###              #    #                #           *  #    #       #
#    #                       #    #                #              #    #       #
#    #     #        ###      #    #         ##     #              #    #       #
#    #     #                 #                     #                   #       #
#    #             #         #########    ##       ##########    ##### #       #
#    ########      #         #             #       #        #          #       #
#    #             #         #             #       #        #          #       #
#    #             #         #             #       #                   #       #
#    #             #         #                     #                   #       #
#    #             #         ##################    #         #######   #       #
#    #             #         #       #             #             #     #       #
#    ############    ####### #                     #   #### #    #     #       #
#    #                       #                     #        #    #     #       #
#    #                                             #        #          #       #
#    #                                             #        #          #       #
#    #                                                                 #       #
#    ###########    ################################################## #       #
#    #                  #      #                                       #       #
#    #                  #      #                                       #       #
#    #                  #                                              #       #
#    #                  #                                              #       #
#    #       #   ###### #                                              #       #
#    #       #          #                                              #       #
#    ####    #          #                                              #       #
#    #       #           ##########################    ############### #       #
#    #       #                    #                                    #       #
#    #       #                                                         #       #
#    #                                                                 #       #
#    ##    ############ #                                              #       #
#    #                  #                                              #       #
#    #                  #         #                                    #       #
#    #                  #         #                                    #       #
################################################################################
