80 80
################################################################################
#      #     #    #    #                 #     #    #                 #        #
#      #     #    #    #                 #          #                 #        #
#      #     #    #    #                 #          #                 #        #
#      #     #    #    #        #        #          #        #        #        #
#      #     #    #    #        #        #          #        ####     ###    ###
#   ## #     #    #    #        #        #    ##### ##    ## #        #        #
#      #     #    #    #        #        #     #    #        #        #        #
#      #     #    #    #        #        #     #    #        #        #        #
#      #     #    #    #        #        #     #    #        #        #        #
#      #     #    #    #        #              #    #        #        #        #
#      ##    #    #    #        #              #    #        #        #        #
#      #     #    #    #        #              #    #        #        #        #
#      #     #    #    #        #              #    #########    #### #        #
#      #     #    #    #        #        #     #    #                 #        #
#      #     #         #        #        #     #    #                          #
#      #     #         #        #        #     #    #                          #
#      #     #         #        ######   #     #    #      #    #              #
#      #               #        #        #     #    #      #    #              #
#      #          #    #        #        #     #    #######     #    ##        #
#      #          #    #    ### #        #          #           #     #        #
#      #          #    #        #        #          #           #     #        #
#      #     #    #    #        #        #          #           #     #        #
#      #     #    #    #        #        #          #           #              #
#      ####    ## #    #        #        #     #    #########    ###############
#      #     #    #    #        #        #     #    #     #    #      #        #
#      #     #    #    #        #        #     #    #     #    #      #        #
#      #     #    #    #        #        #     #    #     #    #      #        #
#      #     #    #    #        #        #     #    #     #    #      #        #
#      ###   #    #    #        #        #     #    #     #    #      #        #
#      #     #    #    #        #        #     #    #     #    #      #        #
#      #     #    #    #        #        #     #    #     #    #      #        #
#      #     #    #    #        #                   #     #    #      #        #
#      #     #    #    #        #################   #     #    #      #        #
#      #     #    #    #        #     #        #    #          #      #        #
#      #     #    #    #        #     #        #    #          #      #        #
#            #    #    #        #     #        #    #          #               #
#            #    #             #     #        #    #          #               #
#            #    #             #     #####    #    #          #    ##         #
#            #    #             #     #        #    #          #               #
#      #          #             #                   ##    #### #      #        #
#      #          #    #        #                   #     #    #      #        #
#      #          #    #        #                   #     #    #      #        #
#      #          #    #        #                   #     #    #      #        #
#      #     #    #    #        #     #             #          #      ###    ###
#      #     #    ###    ###### #     #                        #      #        #
#                 #       #     #     ####    ######           #      #        #
###############   #       #     #     #     #                  #      #        #
#          #      #       #     #     #     #             #    #      #        #
#          #      #             #     #     #       #     #    #      #        #
#                 #             #     #     #       #     #    #      #        #
#                 #             #     #             #     #    #      #        #
#                 #             #     #             #     #    #      #        #
##################    ######### #     #             #     #    #      #        #
#   #                           #     #             #     #    #      #        #
#   #                           #     #     #       #     #    #               #
#   #                           #     #     #       #     #    #    ############
#                               #     #     #       #     #    #        #      #
#                     #         #     #     #       #     #    #        #      #
#                     #         #     ##    #       #     #    #        #      #
#                     #         #     #     #       #     #    #        #      #
#   #                 #         #     #     #       #     #    #        #      #
#   #                           #     #     #       #     #    ##    ## #      #
#   ###################    #### #     #     ####    #     #    #        ##    ##
#   #    #               #      #     #     #       #     #             #      #
#   #    #               #      #     #     #       #     #             #      #
#   #    #               #      #     #     #       #     #             #      #
#   #    #               #      #     #     #       #     #             #      #
#   #                    #      #     #     #       #     #    #        #      #
#   #                        *  #     #     #       #     #    #               #
#   #                           #     #     #       #     #    #               #
#   #                           #     #     #       #     #    #               #
#   #    #                ###   #     #     #       #     #    #               #
#   #    #               #      #     #                                        #
#   #    #               #      ####    ########################################
#   ##    ############## #      #                                  #           #
#   #                    #      #                                  #           #
#   #                    #      #                                              #
#   #                    #      #                                              #
################################################################################
