80 80
################################################################################
#   #     #         #       #                                                  #
#   #     #         #       #                                                  #
#   #     #         #       #                                 #                #
#   #     #         #       ###########    ################## ##    ############
#   #     #         #       #                    #            #                #
#   #     #         #       #                    #            #                #
#   #     #         #       #                    #            #                #
#   #     #         #       #                                 #                #
#   #     #         #       #                                 #                #
#   #     #         #       #                                                  #
#   #     ####      #       #########################################    #######
#   #     #         #       #           #                                      #
#   #     #         #       #           #                                      #
#   #     #         #       #           #                                      #
#   #     #         ##      #           #                                      #
#   #     #         #       #           #################################    ###
#   #     #         #       ##    ##### #     #     #     #              #     #
#   #     #         #       #      #    #     #     #     #              #     #
#   #     #         #       #      #    #     #     #     #              #     #
#   #     #                 #      #    #     #           #                    #
#   #     #                 #      #    #     #           #                    #
#   #     #                 #      #    #   ##                                 #
#   #     ##########    ### #      #    #                                      #
#   #     #                 #      #    #      ##   ###    ########    #########
#   #     #                 #      #    #           #                          #
#   #     #                 #      #    #     #     #     #                    #
#   #     #            #    #      #          #     #     #                    #
#   #     #     #      #    #      #          #     #                          #
#   #     #     #      #           #     #####      ##    ######################
#   #     #            #           #          #     #                      #   #
#   #     #######      #           #    #     #     #                      #   #
#   #     #            #           #    #     #     #                          #
#   #     #            #    #      #    #     #     #                          #
#   #     #            #    #      #    #           #                          #
#   #     #            #    #           #           #                          #
#   #     #     #      #    #           #           #                      #   #
#         #     #      #    #           #           #                      #   #
#         #                                                                    #
#         ###################################################################  #
#         #               #                                        #       #   #
#   #     #               #                                        #       #   #
#   #     #               #                                        #       #   #
#   #     #                                                        #       #   #
#   #     #                                                   #            #   #
#   #     #                                                   #            #   #
#   #     #                                                   #            #   #
#         #                                                   #            #   #
######    ##########    ##################################### #    #       #   #
#    #    #           #    #            #                     #    #       #   #
#    #    #           #    #            #                     #    #       #   #
#    #    #           #    #            #                     #    #       #   #
#    #    #      #    #                                       #    #   ### #   #
#    #    #      #                                            #    #           #
#    #    ###    #                                            #    #           #
#    #    #      #             ############################## #    #           #
#    #    #      #         #                #        #        #    #           #
#    #           #####     #                #        #        #    #       #   #
#    #           #    #    #                #        #        #    #       #   #
#    #           #    #    #                         #        #            #   #
#    #           #    #    #         #               #        #   ######## #   #
#    #    #      #    #    #         #               #        #            #   #
#    #    #      #    #    #         #               #        #            #   #
#    #    #      #         ####      #    ########## #        #            #   #
#    #    #      #         #         #               #        #       #    #   #
#    #    #                #         #               #        #       #    #   #
#    #    #   ############ #         #               ####     ####    #    #   #
#    #    #    #           #                         #        #       #    #   #
#    #    #    #           ####    ################# #        #       #    #   #
#    #    #    #           #                 #       #        #       #    #   #
#    #    #    #      #    #                         #        #            #   #
#    #    #           #    #                         #        #############    #
#    #    #           #    #                         #        #          #     #
#    #    #           #    #                         #        #          #     #
#    #    #           #    ###    ########## #####   #        #          #     #
#    #    #####    ## #    #            #    #       #        #                #
#         #           #    #                 #                #                #
#         #           #    #                 #         *      #                #
#         #           #    #                 #                #                #
################################################################################
