80 80
################################################################################
#                #                #     #    #    #    #    #       #     #    #
#                #                #     #    #    #    #    #       #     #    #
#                                 #     #    #    #    #    #       #     #    #
#                                 #          #    #    #    #       #     #   ##
#                                 #          #    #    #    #       #          #
#                                 #          #    #    #    #       #          #
#                                 #          #    #    #    #       #   ##     #
#                                 #   ###### #    #    #    #####   #          #
##    ########################### #    #     #    #    #    #       #     #    #
#               #        #        #    #     #    #    #    #       #     #    #
#               #                 #    #     #    #    #    #       #     #    #
#               #                 #    #     #    #    #    #       #     #    #
#               #                      #     #    #    #    #       ####    ####
#########    ## #                            #    #    #    #       #     #    #
#                ###    ##########           #    #    #    #             #    #
#                      #                     #    #    #    #             #    #
#                      #          #          #    #    #    #                  #
#    #                 #          #    #     #         #    #                  #
#    ###    ### #                 #    #     #         #    #                  #
#    #          #                 #    #     #         #    ################   #
#    #          #                 #    #     #         #    #    #    #    #   #
#    #          #                 #    #     #    #    #    #    #    #    #   #
#                                            #    #    #    #    #    #    #   #
#########################################    #    #    #    #    #    #    #   #
#          #      #     #    #    #     #    #    #    #    #    #    #    #   #
#          #      #     #    #    #     #    #    #    #    #    #    #    #   #
#          #      #     #    #    #     #    #    #    #    #    #    #    #   #
#          #      #     #         #     #    #    #    #    #    #  * #    #   #
#    ######       #               #          ###    ## #    #    #    #    #   #
#   #             #               #          #    #    #    #    #    #    #   #
#   #             #               #          #    #    #    #    #    #    #   #
#                 #          #    #          #    #    #    #    #    #    #   #
#          #      #     #    #    #     #    #    #    #    #    #    #    #   #
#          #      #     #    #    #     #    #    #         #         #    #   #
#          #      #          #    #     #    #    #         #         #    #   #
#                 #######    #    #     #    #    #         #         #    #   #
##############    #          #    #     #    #    #         #         #    #   #
#                 #          #    #     #    #    #    #    #    #    #    #   #
#                 #          #    #     #    #    #    #    #    #    #    #   #
#                 #     #    #    #     #    #    #    #         #    #    #   #
#     #     #     #     #    #    #     #         #    #         #    #    #   #
#     #     #     ###   #    #    #     #         #    #         #    #        #
#     ######      #     #    #    #     #         #    #         #    #        #
#     #           #     #    #    #     #         #    #    #         #        #
#     #           #     #    #    #     #    #    #    #    ######    #        #
#     #           #     #    #    #     #    #    #    #    #    #    #        #
#     #           #               ######     #    #    #    #    #    #        #
#     #           #   ############           #    #    #    #    #    #######  #
#     #     #           #                    #    #    #    #    #    #    #   #
#     #     #                                #    #    #    #    #    #    #   #
#     #     #                                #    #    #    #    #    #    #   #
#     #     #                     #     #    #    #    #    #    #         #   #
#     #     #     #               #     #    #    #    #    #    #         #   #
#     #     #     #               #     #    #         #    #    #         #   #
#     #     #     #                          #         #    #    #         #   #
#  ## #     #     #########    ############# #              #    #    #    #   #
#     #     #     #                    #     #    ######### #    #    #    #   #
#     #     #     #                    #     #    #    #    #    #    #    #   #
#     #     #     #                    #     #    #         #    #    #    #   #
#     #     #     #                    #     #    #         #    #    #    #   #
#     #     #     ##########    ###### #     #    #         #    #    #    #   #
#     #     #     #             #      #     #    #         #         #    #   #
#     ###   #     #             #      #     #    ##    ### #         #    #   #
#     #     #     #             #            #              #         #    #   #
#     #     #     #                          #              #         #    #   #
#     #     #     #                          #              #    #    #    #   #
#     #                                                     #    #    #        #
######    ################################################# #    #    #        #
#                                                    #      #    #    #        #
#                                                           #    #    #        #
#                                                           #    #    #    #   #
#                                           #               #    #    #    #   #
##############################    ######### #               #    #    #    #   #
#                                           #    ########## #    #    #    #   #
#                                           #               #    #    #    #   #
#                                           #               #    #    #    #   #
#                                           #               #    #    #    #   #
#                  #                        #         #     #    #    #    #   #
################################################################################
