80 80
################################################################################
#       #                 #           #                               #    #   #
#       #                 #           #                               #    #   #
#       #                 #           #                               #    #   #
#       #         #       #     #     #                               #    #   #
#       #         #       #     #     #                     #         #    #   #
#       #         #       #     #     ##################    ######### #    #   #
#       #                 #           #           #     #             #    #   #
#       #####    ######## #######     #           #     #             #    #   #
#       #       #    #    #           #                               #    #   #
#       #       #    #    #           #                               #    #   #
#       #       #    #    #           #      #           #########    #    #   #
#       #       #    #    #           #      #####    ##       #      #    #   #
#       #       #    #    #      #    #      #          #             #    #   #
#       #       #    #    #      #    #      #          #             #    #   #
#       #       #    #    #      #    #      #          #             #    #   #
#       #       #    #    #      #    #      #          #             #    #   #
#       #       #    #    #      #    #      ###########    ######### #    #   #
#       #       #    #    ###    #    #      #                        #        #
#       #       #         #      #           #                        #        #
#       #       #         #      #           #                        #        #
#       #       #         #      #           #                        #        #
#       #       #         #                                           #    #   #
#       #       #    #    ##########################    ############# #    #   #
#       #       #    #    #     #                      #              #        #
#       #       #    #    #                            #              #######  #
#       #       ###    ## #                            #              #        #
#       #       #    #    #                            #     #        #        #
#       #       #    #    #                            #     #                 #
#       #       #    #    #                            #     #                 #
#       #       #    #    ##############    ########### ###    #######     #   #
#       #       #    #    #                                                #   #
#       #       #    #    #                                           #    #   #
#       #       #    #    #                                           #    #   #
#       #       #    #    #                                                    #
#       #       #    #    ######################################    ############
#       #       #    #    #    #           #              #      #      #      #
#               #    #    #    #           #              #      #      #      #
#               #    #    #    #           #              #      #      #      #
#               #    #    #    #           #                     #      #      #
#               #    #    #    #           #                     #      #      #
#       #       #    #    #    #####    ## #                     #             #
#       #       #    #    #    #    #      #                     #             #
#       #       #    #    #    #    #      #              #      #             #
#       #       #    #    #    #    #      ###########    ###### #   ###########
#       #####   #    #    #    #    #      #                                   #
#       #       #    #    #    #    #      #                                   #
#       #       #    #    #    #    #      #                                   #
#       #       #    #    #    #    #      #                                   #
#       #       #    #    #    #    #      #############################    ####
#       #       #         #    #    #      #        #    #     #               #
#   ### #       #         #    #    #      #        #    #     #               #
#       #       #         #    #    #      #        #    #     #               #
#       #       #         #    #    #      #        #    #     #               #
#       #            #    #    #           #        #          #    #    #######
#       #            #    #    #           ###      #          #    #          #
#       #            #    #                #        #          #    #          #
#       #            #    #                #        #          #    #          #
#       #       #    #    #         #      #    *   #    #     #               #
#       #       #    #    #         #      #        #    #     #########    ####
#       #       #    #    #    #    #      #        #    #     #     #         #
#       #       #    #         #    #      #        #    #     #     #         #
#       #       #    #              #      #        #    #     #     #         #
#                    #     #######    #####         #    #     #     #         #
#####################             #                 ##    #### #     #         #
#   #               #     #       #                       #    #     #    #    #
#   #               #     #       #                            #     ######    #
#                   #     #       #        #                   #     #     #   #
#                         #       #        #                   #     #     #   #
#                         #       #        #                   #     #     #   #
#                         #       #        #                   #     #     #   #
#                         #       #        #   ############### #     #     #   #
#################   #     #       #        #                   #     #     #   #
#                   ###   #####   #        #                   #     #     #   #
#                   #     #             ## #                   #     ###   #   #
#                   #     #                #        #          #     #         #
#                   #     #                #        #          #               #
#             #     #     #                #        #                          #
#             #     #     #       #        #        #                          #
################################################################################
