80 80
################################################################################
#                   #         #                            #     #     #       #
#                             #                            #     #     #       #
#                                                          #     #     #       #
#                                                                #             #
##########################                                       #             #
#                                                                #             #
#                             #                                  #             #
#                             #                                  ##########    #
#           #                 #################    ############# #    #    #   #
#     #     #                 #                         #        #    #    #   #
#######     #############     #                                  #    #    #   #
#           #                 #                                  #    #    #   #
#           #                 #                                  #    #    #   #
#           #                 #                                  #    #    #   #
#                                                                #    #    #   #
########################################################    #### #    #    #   #
#        #    #        #    #        #                      #    #    #    #   #
#        #    #        #                                    #    #    #    #   #
#        #    #        #                                    #    #    #    #   #
#        #    #        #                                    #    #    #    #   #
#        #    #        #                                    #    #    #    #   #
#        #    #        #    ###############    ############ #    #    #    #   #
#        #    #        #    #                               #    #    #    #   #
#        #    #        #    #                               #    #    #    #   #
#        #    #        #    #                               #    #    #    #   #
#        #    #        #                                    #    #    #    #   #
#             ####     #########################    ####### #    #    #    #   #
#             #        #        #             #       #     #    #    #    #   #
#                      #        #                     #     #    #    #    #   #
#                      #        #                     #     #    #    #    #   #
#        #             #        #                     #     #    #    #    #   #
#        #             #        #######    ###        #     #    #    #    #   #
#        #    #        #        #             #             #    #    #    #   #
#        #    #        #        #             #             #    #    #    #   #
#        #    #        #        #             #             #    #    #    #   #
#        #    #                 #                           #    #    #    #   #
#        #    #                 #########    ######## #     #    #    #    #   #
#        #                      #                     #     #    #    #    #   #
#        ########    ##         #                     #     #    #    #    #   #
#        #     #       #        #                     #     #    #    #    #   #
#        #     #       #        #                           #    #    #    #   #
#        #     #       ####     #########    ############## #    #    #    #   #
#        #     #       #        #     #               #     #    #    #    #   #
#        #     #####   #        #     #                     #    #    #    #   #
#        ###   #       #        #     #                     #    #    #    #   #
###      #             #        #     #                     #    #    #        #
#        #             #        #     #                     #    #    #        #
#        #             #        #     #                     #    #    #        #
#        #             #        #     ###################   #    #    ###    ###
#        #     #       #              #           #              #    #        #
#        #     #       #              #           #              #    #        #
#        #     #       #              #           #              #    #        #
#                      #                                         #    #    #   #
###################    #                                         #    #    #   #
#    #      #    #     #                                         #    #    #   #
#    #      #    #     #######################    ############## #    #    #   #
#    #                 #      #       #      #            #      #    #    #   #
#    #                 #      #       #      #            #      #         #   #
#    #                 #      #       #      #                   #         #   #
#    #                 #      #              #                   #         #   #
#    #      ######     #      #     *        #                   #         #   #
#    #      #     #    ##     #              ####    #####       #    #    #   #
#    #      #     #    #      #              #            #      #    #    #   #
#    #      #     #    #      #########      #            #      #    #    #   #
#    #      #     #    #      #     #        #            #      #    #    #   #
#    #      #     #    #      #              #            #      #    #    #   #
#    #      #     #    #                     #            #      #    #    #   #
#    ####   #     #    #                     #                   #    #    #   #
#    #      ###   #    #                     #################   #    #    #   #
#    #      #     #    #            #        #    #        #     #    #    #   #
#    #      #          #            #        #                   #    #    #   #
#    #      #          #                     #                   #    #    #   #
#    #                 ###    ############## #                        #    #   #
#    ###    ########## #           #         #              ##        #    #   #
#                      #           #               ####### #          #    #   #
#                      #                                   #          #    #   #
#                      #                                   #     #    #    #   #
#                      #                                   #     #    #    #   #
################################################################################
