80 80
################################################################################
#                                                                              #
#                                                                              #
#                                                        #                     #
#                                                        #                     #
#       #                                                #                     #
#       #                                                #                     #
#       #                                                                      #
#       #############################    #######################################
#       #        #    #        #                          #              #     #
#       #             #        #                          #              #     #
#       #             #        #                          #              #     #
#       #             #        #                          #              #     #
#       #             #        #                          ###    ########      #
#       #        #    #        ###################    ### #    #               #
#       #        #    #        #           #    #         #    #               #
#       #        #    #        #           #              #    #               #
#       #        #    #        #           #              #              #     #
#       #        #    #        #           #              #              #     #
#       #        #    #        #######     #              #                    #
#       #####    #    #        #           #    #    #    #########    #########
#       #        #    #        #           #    #    #    #    #         #     #
#       #        #    #        #           ###    ## #    #              #     #
#       #        #    #        #           #    #    #                   #     #
#       #        #    #        #    ##     #    #    #                   #     #
#       #        #    ####     #     #          #    #                   #    ##
#       #        #    #        #     ##              #                   #     #
#       #        #    #        #     #               #    #####    ##### #     #
#       #        #    #        #     #               #    #              #     #
#       #        #    #        #     #     ##########     #                    #
#       #        #    #        #     #     #         #    #                    #
#       #        #    #        #     #     #         #    #                    #
#       #        #    #        #     #     #              #        #           #
#       #        #    #        #     #     #              #        #     #     #
#       #        #    #        #     #     #              #        #     #     #
#       #             #        #                                         #     #
#       #   ######### #        #########################################    ####
#       #             #        #      #    #                         #    #    #
#       #                      #      #    #                         #    #    #
#       #                      #      #                              #         #
#       #      #               #                #                    #         #
#       ####   ##              #                #                    #         #
#       #      #      #        #                #                    #####    ##
#       #      #      #        #           #    #   ################ #    #    #
#       #      #      #        #      #    #    #    #               #    #    #
#       #      #      #        #      #    #    #    #                    #    #
#       #             #        #      #    #    #                         #    #
#       ############    ###### #      #    #    #                         ###  #
#       #        #       #     #      #    #    #     ###########         #    #
##      #                      #      #    #    #           #        #    #    #
#       #                      #      #    #    #    #      #        #    #    #
#       #                      #      #    #    #    #      #        #    #    #
#       #                      #      #    #    #    #               #         #
#       #        ##    ####### #      #    #    #    #               #         #
#       #        #    #        #      #    #    #    #               #         #
#       #        #    #        #      #    #    #    #               #         #
#       #        #    #        #      #    #    #                              #
#       #        #    #        #      #    #    ##########    ##################
#       #        #    #        #      #    #    #      #         #             #
#       #        #    #        #      #         #      #         #             #
#       #        #    #        #      #######   #      #         #             #
#       #        #    #        #      #         #      #         #             #
#       #        #    #        #      #         #                ##########    #
#       #        #    #        #      #         #                #      #      #
#       ######   #    #               #         #                #      #      #
#       #        #    ####            #    #    #                #             #
#       #        #    #               #    #    ###########      #             #
#       #        #    #               #    #    #                #             #
#       #        #    #        #    * #    #    #                #             #
#       #        #    #        ##     #    #    #                #      #      #
#       #        #    #        #      #    #    #                #      #      #
#       #        #             #      #    #    #         #      #      #      #
#       #        #             #      #    #    ####      #      #      #      #
#       #        #             #      #    #    #         #      #   ## #   ####
#       #        #             #           #    #         #      #      #      #
#       #        #    #        ###########      #         #             #      #
#       #        #    #        #                #         #             #      #
#       #        #    #        #                #         #             #      #
#       #        #    #        #                #         #             #      #
################################################################################
