80 80
################################################################################
#                     #                    #       #    #                      #
#                                          #       #    #                      #
#                                          #       #    #                      #
#                                          #       #    #                      #
#   #    #    #                            #       #    #               #      #
#   #    #    ##########################   ####                         #      #
#   #    #    #    #            #     #    #                                   #
#   #    #    #                 #     #    #             ####################  #
#   #    #    #                 #     #    #                   #    #    #     #
#   #    #    #                 #     #    #            #      #         #     #
#   ###    ## #     ########    #          ######    ## #      #         #     #
#   #         #    #            #          #       #    #      #         #     #
#   #         #    #            #          #       #    #      #         #     #
#   #         #    #            #          #       #    #      #    #    #     #
#   #         #                 #     #    #       #    #      #    #    #     #
#    ######## ###############   #     #    #       #    #      #    #    #     #
#       #     #    #            #     #    #       #    #      #    #    #     #
#       #     #    #            #     #    #       #    #      #         #     #
#       #     #    #            #          #       #    #      ######    #     #
#       #     #    #            #    ##### #       #    #      #    #    #     #
#       #     #    #            #    #     #            #      #    #    #     #
#       #     #    ##    ###### #          #            #      #    #    #     #
#       #     #            #    #          ##    ##     #      #    #    #     #
#       #     #            #    #          #            #      #    #    #     #
###     #     #            #    #          #       #    #      #    #    #     #
#       #     #            #    #    #     #       #    #      #         #     #
#             #    #       #    #    #     #       #    #      #         #     #
#             #    #            #    #     #       #    #      #         #     #
#             #    #            #    #     #       #    #      #         #     #
#             #    #            #    #     #       #    #      #    #    #     #
#       #     #    ##    ##     #    #     #       #    #      #    #    #     #
#       #     #    #       #    #    #     #       #    #           #    #     #
#       #     #    #       #         ###   #       #    #           #    #     #
#       #     #    #       #         #     #       #    #           #    #     #
#       #     #    #       #         #     #       #    #           #    #     #
#       #     #    #       #         #     #       #    #      #    #    #     #
#                                          #       #    #      #    #    #     #
###############    ####################### #       #    ###    #    #          #
#           #                   #    #     #       #    #      #    #          #
#           #                   #    #     #       #    #      #    #          #
#           #                   #    #     #       #    #      #    #          #
#           #                   #    #     #       #    #                ##    #
#  ######## #     #####    #### #    #             #    #   ############ #     #
#                #              #    #             #    #    #           #     #
#                #              #    #             #    #                #     #
#                #              #    ###           #    #                #     #
#                #        #     #    #     #       #    #                #     #
#   #       #    #        ###   #    #     #                                   #
#   #       #    #        #     #    #     ###############################    ##
#   #            #        #     #    #     #     #          #    #      #      #
####    ######## ####     #     #    #     #     #          #    #      #      #
#                #        #     #    #     #     #          #    #      #      #
#                #        #     #    #     #     #          #    #      #      #
#                #        #     #    #     #     #          #    #      #    ###
#                #        #     #    #     #     ######          #      #      #
#                               #          #     #               #      #      #
####################    ####### #          ###   #                ##    #      #
#    #    #    #    #           #          #     #                      #      #
#    #    #    #    #           #          #     #                      #      #
#         #    #                ######     #     #########    ###       #      #
#         #    #                #     #    #     #               #      #      #
#         #    #                #     #    #     #               #      #      #
#         #    ###########      #     #    #                     #      #      #
#    #    #    #     #          #     #    #                            #      #
#    #         #     #          #     #    #      ################      #      #
#    #         #     #          #     #    #                #           # *    #
#    #         #     #     #    ###   #    #     #          #           #      #
##    ####     #     #     #    #     #    #     #          #           #      #
#         #          ###    ### #     #    #     #          #                  #
#         #          #    #     #     #    #     ####    ### ##    #####       #
#         #     ##   #    #           #    #     #                             #
#                    #    #           #    #     #                             #
###    ####### #     #                #    #     #                             #
#       #      #     #                #    #     #                             #
#       #      #     #          #     #    #     ################    ###########
#              #     #          #     #    #     #                             #
#              #          #     #          #     #                             #
#              #          #     #          #     #                             #
################################################################################
