80 80
################################################################################
#                  #     #             #       #     #          #          #   #
#                  #     #             #       #     #                     #   #
#                  #     #             #             #                         #
#                  #     #             #             #                         #
#                        #####    #### #             #                         #
#                        #      #      #             #          #              #
#                               #      #       #     #          #          #   #
#                               #      #       #     #                     #   #
##############    #######       #      ######    ### #############    #### #   #
#        #                                                           #     #   #
#                        #                                           #     #   #
#                        #   ###                                     #     #   #
#                        #                      #                          #   #
#                        #      #      #        #                          #   #
#        #               #      #      #                                   #   #
#        #                             ####    ########################### #   #
#########    ######################### #                            #      #   #
#                                      #                                   #   #
#                                      #                                   #   #
#                                      #                                   #   #
#                                                                          #   #
########################################################    ############## #   #
#   #       #    #    #    #        #      #       #       #        #      #   #
#   #       #    #    #    #        #      #       #       #        #      #   #
#   #       #    #    #             #              #       #               #   #
#   #       #         #             #              #       #               #   #
#   #       #         #             #              #       #               #   #
#   #    ## #         #             #              #       ###    ######## #   #
#           ######     #####    ### ###    ####### #       #    #    #     #   #
#                #          #       #         #    #    ## #    #    #     #   #
#                #          #       #         #            #    #    #     #   #
#                #          #       #         #            #    #    #     #   #
#######          #    #     #       #                      #    #    #     #   #
#           #    #    #     #       #                      #         #     #   #
#           #    #    #     #       #              #       #         #     #   #
#           #         #    ##       #              #       #         #     #   #
#    #      #         #             #              #       #               #   #
#    #      #         #             ############    ###### #    #          #   #
#    #      #         #             #       #              #    #          #   #
#    #                #             #       #              #    #          #   #
#####    ############ #     ##      #       #              #    #    #     #   #
#        #            #     #       #       #                   #    #     #   #
#        #            #     #       #       #                   #    #     #   #
#                     #     #       #            #              #    #     #   #
#                     #     #       #            #              #####      #   #
#                                   #                      #    #          #   #
#    ############################## #        ######    ### #    #          #   #
#     #    #                        #       #     #        #    #          #   #
#     #    #                        #       #     #        #    #          #   #
#          #                        #    ## #     #        #    #          #   #
#                                   #       #     #        #    #    #     #   #
#                                   #       #              #    #    #     #   #
#                                   #       #              #    #    #     #   #
#     ###################    ###### #                                      #   #
#     #        #         #    #     #############################    ##### #   #
#     #        #         #    #            #       #       #    #          #   #
###   #                  #    #            #       #       #    #          #   #
#     #                  #    #            #       #       #    #          #   #
#     #                  #    #            #       #       #    #          #   #
#     #                       #     #                      #    #     #    #   #
#     #                       #     #                      #    ##    #    #   #
#     ################        #  *  #                                 #    #   #
#     #                       #     #                                 #    #   #
#     #                  #    #     #      #                          #    #   #
#     #                  #    #     #   ## ###    #########           #    #   #
#     #                  #    #     #      #               ###    ### #    #   #
#     #     #            #    #     #      #               #          #    #   #
#     #     #                 #     #      #               #          #    #   #
#     ######    ############# ##    #      #               #          #    #   #
#     #                #      #     #                      #               #   #
#     #                #      #     ###########    ####### #############   #   #
#     #                #      #     #                      #    #          #   #
#     #                       #     #                      #    #          #   #
#     #                       #     #                      #    #          #   #
#     #    ############     ##      #                      #    #          #   #
#     #                             #              #       #    #          #   #
#     #                #            #              #       #               #   #
#     #                #            #              #       #               #   #
################################################################################
