80 80
################################################################################
#    #    #        #            #                    #      #      #           #
#    #    #        #            #                    #      #      #           #
#    #                          #                    #      #      #           #
#    #                          #                    #      #      #        ####
#    #                          #                    #      #      #    #      #
#                               #####    ############       #      #    #      #
#         #                     #               #           #      #    #      #
#         ################      #               #           #      #    #      #
#         #        #     #      #               #           ###    #    #      #
###    ## #        #     #      #                    #      #      #    #      #
#         #        #     #      #                    #      #      #    #      #
#         #        #     #      #                    #      #      #    #      #
#         #        #     #      #####################    ## #      #    #      #
#         #        #     #   ## #     #           #    #    #      #    #      #
#         #        #            #     #           #    #    #      ###    ######
#   ##    #        #            #     #           #    #    #      #      #    #
#    #    #        #   ##             #      #    #    #    #      #      #    #
#    #    #        #                  #      #    #    #    #      #      #    #
#    #    #        #     #            #      #    #    #    #      #      #    #
#    #    #####    #     #            #      #    #    #    #      #      #    #
#    #    #        #            #     ####    ### #    #    #      #      #    #
#    #    #        #######      #            #    #    #    #      #      #    #
#    #    #        #            #            #    #    #    #      #      #    #
#    #    #                     #            #    #    #    #      #      #    #
#    #    #                     ###          #    #         #      #      #    #
#    #    #                     #     ##          #         #      #      #    #
#    #    #                     #     #           #         #      #      #    #
#                               #     #           #    #### #      #      #    #
###########    ################ #     #           #         #      #      #    #
#                       #       #                 #                #      #    #
#                       #       ##########    ####                 #      #    #
#                               #                                  #      #    #
#                               #                      #           #      #    #
#                               #                      #    #      #      #    #
#                                                           #      #      #    #
##########################################    ############# #      #      #    #
#      #    #                    #     #       #            #      #      #    #
#      #                         #     #                    #      #      #    #
#      #                         #     #                    #      #      #    #
#      #                  #      #     #               #    #      #      #    #
#  ### #          #       #      #     #               #    #      #      #   ##
#      #          #       #   ## #    *#       ######    ## #      #      #    #
#      #   ###### #    ## #      #     #       #     #      #      #      #    #
#                 #       #      #     #       #     #      #      #      #    #
#                 #       #      #             #     #      #      #      #    #
#                 #       #      #             #     #      #      #      #    #
#                 #       #      #             #     ##     #      #      #    #
#############     #       #      #             #     #      #      #      #    #
#        #        #              #     #       #     #      #      #      #    #
#        #        ############   #     #       #     #      #             #    #
#        #        #              #     #       #     #      #             #    #
#        #        #              #     ##      #     #      #             #    #
#   #### #        #              #     #       #            #             #    #
#   #    ###      #              #     #       #            #      #      #    #
#        #        #         #    #     #       #            #      #      #    #
#                 #         #    #     #       #            #      #      #    #
#                 #         #    #     #       #     #      #      #      #    #
#                                ####    ##### #     #      #      ####   #    #
####    ######################## #             #     #      #      #           #
#   #                     #      #             #     #      #      #           #
#   #                     #      #             #     #      #      #           #
#                         #      #                          #      #           #
#           #       #     #      ################    ###### #      #           #
#           #       #     #      #    #                     #####    ###########
#           #             #      #    #                     #    #    #        #
#           #   ######### #      #    #                     #    #             #
#    ###### #             #      #    #                     #    #             #
#           #             #      #    #                     #    #             #
#           #             #      #    ##    ############### #    #             #
#           #             #      #                          #    #######    ####
#                         #                                 #    #             #
###############    ###### #                                 #    #             #
#       #                 ###                               #                  #
#                         #           #             ##      #                  #
#                                #    ###########   #       #         #    #####
#                                #    #             #       #         #        #
#                                #    #             #       #    #    #        #
#       #                        #    #             #       #    #    #        #
################################################################################
